A R S Sport Strip - Belle Plaine, MN
Aanenson - Luverne, MN
Abbeville Crusta Memorial - Abbeville, LA
Abbeville Municipal - Abbeville, AL
Aberdeen Municipal - Aberdeen, ID
Aberdeen Municipal Airport - Aberdeen, SD
Abernathy - Pulaski, TN
Abernathy Municipal - Abernathy, TX
Abide - Greenville, MS
Abilene Municipal Airport - Abilene, TX
Abrams Municipal - Grand Ledge, MI
Acadiana Regional Airport - New Iberia, LA
Accomack County Airport - Melfa, VA
Ace - Anderson, IN
Ackerman-Choctaw Co - Ackerman, MS
Ackley Municipal - Ackley, IA
Ada - Ada, OH
Ada Airport - Ada, OK
Adak Island Naval Station - Adak Island, AK
Adams Co Legion - Friendship, WI
Addison Airport - Dallas, TX
Addison Municipal - Addison, AL
Adin - Adin, CA
Adirondack Airport - Saranac Lake, NY
Aero Country - Mc Kinney, TX
Aero Park - Menomonee Falls, WI
Aeroflex-Andover - Andover, NJ
Af Aux Airport - Indian Springs, NV
Afton Municipal Airport - Afton, WY
Agua Caliente Springs - Agua Caliente Springs, CA
Agua Dulce - Agua Dulce, CA
Aiken Municipal Airport - Aiken, SC
Ainsworth Airport - Ainsworth, NE
Air Harbor - Greensboro, NC
Air Park South - Ozark, MO
Airglades - Clewiston, FL
Airhaven - Staatsburg, NY
Airlake - Minneapolis, MN
Airlane Enterprises - Clay, NY
Airpark East - Dallas, TX
Airpark-Dallas - Dallas, TX
Airport - City, OR
Airport Manatee - Palmetto, FL
Airtrek - Waterloo, NY
Aitkin Mun - Kurtz - Aitkin, MN
Ajo Municipal - Ajo, AZ
Akhiok Sea Plane Base - Akhiok, AK
Akiachak Sea Plane Base - Akiachak, AK
Akiak Airport - Akiak, AK
Akron - Akron, NY
Akron Fulton International - Akron, OH
Akron Municipal - Akron, IA
Akron-Canton Airport - Akron, OH
Akutan Airport - Akutan, AK
Alakanuk Airport - Alakanuk, AK
Alameda Naval Air Station - Alameda, CA
Alamo Landing - Alamo, NV
Alamo-Navajo - Alamo, NM
Alamogordo Municipal Airport - Alamogordo, NM
Alamosa Municipal Airport - Alamosa, CO
Albany International Airport - Albany, NY
Albany Municipal - Albany, OR
Albany Municipal - Albany, TX
Albany Naval Air Station - Albany, GA
Albemarle Airport - Charlottesville, VA
Albert - Philipsburg, PA
Albert J Ellis Airport - Jacksonville, NC
Albert Lea Airport - Albert Lea, MN
Albertus Airport - Freeport, IL
Albia Municipal - Albia, IA
Albion Municipal - Albion, ID
Albion Municipal - Albion, NE
Albuquerque International Sunport - Albuquerque, NM
Alderman - St Clairsville, OH
Aleknagik Airport - Aleknagik, AK
Aleneva Airport - Aleneva, AK
Alexander Field - Wisconsin Rapids, WI
Alexander Municipal - Belen, NM
Alexandria - Alexandria, IN
Alexandria - Pittstown, NJ
Alexandria Bay Airport - Alexandria Bay, NY
Alexandria International Airport - Alexandria, LA
Alexandria Municipal Airport - Alexandria, MN
Algona Airport - Algona, IA
Alice International Airport - Alice, TX
Alitak Sea Plane Base - Alitak, AK
Alkali Lake State - Alkali Lake, OR
Allakaket Airport - Allakaket, AK
Allegheny County Airport - Pittsburgh, PA
Allen Army  Airfield - Delta Junction, AK
Allen County Airport - Lima, OH
Allen Parish - Oakdale, LA
Allendale Co - Allendale, SC
Allentown-Queen City Municipal - Allentown, PA
Alliance Airport - Alliance, NE
Allied - Tulsa, OK
Alma Municipal - Alma, NE
Almena - Paw Paw, MI
Almyra Municipal - Almyra, AR
Alpena County Regional Airport - Alpena, MI
Alpine - Alpine, WY
Alpine Airstrip - Nuiqsut, AK
Alpine Co - Markleeville, CA
Alpine-Casparis Municipal Airport - Alpine, TX
Alta - Dinuba, CA
Altoona Airport - Altoona, PA
Alturas Municipal - Alturas, CA
Altus Air Force Base - Altus, OK
Altus Municipal Airport - Altus, OK
Alva Regional - Alva, OK
Alvin Airpark - Alvin, TX
Alyeska Airport - Alyeska, AK
Amana - Amana, IA
Ambler Airport - Ambler, AK
Amchitka Airport - Amchitka, AK
Amedee Army Air Field - Herlong, CA
American Falls - American Falls, ID
Amery Municipal Airport - Amery, WI
Ames - Trenton, FL
Ames Airport - Ames, IA
Amook Airport - Amook, AK
Anacortes Airport - Anacortes, WA
Anadarko Municipal - Anadarko, OK
Anaheim Airport - Anaheim, CA
Anaktuvuk Airport - Anaktuvuk, AK
Andalusia-Opp Municipal - Andalusia/Opp, AL
Anderson - Brewster, WA
Anderson Airport - Anderson, SC
Anderson Municipal Airport - Anderson, IN
Andrau Airpark - Houston, TX
Andrews Air Force Base - Camp Springs, MD
Andrews Airport - Andrews, SC
Andrews Co - Andrews, TX
Andrews Navy Air Field - Camp Springs, MD
Andrews University - Berrien Springs, MI
Andrews-Murphy - Andrews, NC
Angel Fire Airport - Angel Fire, NM
Angola Airport - Angola, NY
Angoon Seaplane Base - Angoon, AK
Angwin-Parrett - Angwin, CA
Aniak Airport - Aniak, AK
Animas Air Park - Durango, CO
Anita Bay Airport - Anita Bay, AK
Anita Mun-Burke Memorial - Anita, IA
Ankeny Regional - Ankeny, IA
Ann Arbor Municipal Airport - Ann Arbor, MI
Annette Island Airport - Annette Island, AK
Anniston Metropolitan Airport - Anniston, AL
Anoka Co-Blaine - Minneapolis, MN
Anson Co - Wadesboro, NC
Antelope Co - Neligh, NE
Antelope Valley - Grouse, ID
Anthonson - Jordan, NY
Anthony Airport - Anthony, KS
Antlers Airport - Antlers, OK
Anton - Dayton, TN
Antonneau Memorial - Green Bay, WI
Antrim County Airport - Bellaire, MI
Anvik Airport - Anvik, AK
Ap In The Sky Airport - Catalina Island, CA
Apalachicola Municipal Airport - Apalachicola, FL
Apple Valley Airport - Apple Valley, CA
Appleton Municipal - Appleton, MN
Aransas County Airport - Rockport, TX
Arapahoe Municipal Airport - Arapahoe, NE
Arcadia Municipal - Arcadia, FL
Arcadia-Bienville Parish - Arcadia, LA
Arcata Airport - Arcata, CA
Archer City Municipal - Archer City, TX
Arco-Butte Co - Arco, ID
Arctic Village Airport - Arctic Village, AK
Ardmore - Ardmore, AL
Ardmore Downtown Airport - Ardmore, OK
Ardmore Municipal Airport - Ardmore, OK
Arens - Winamac, IN
Argonia Municipal - Argonia, KS
Argyle - Argyle, NY
Arkansas City Airport - Winfield, KS
Arkansas International Airport - Blytheville, AR
Arledge - Stamford, TX
Arlington Municipal - Arlington, OR
Arlington Municipal - Arlington, SD
Arlington Municipal - Arlington, WA
Arlington Municipal Airport - Arlington, TX
Army Air Field Heliport - Fort Devens, MA
Arner Memorial - Lehighton, PA
Arness Lake - Kenai, AK
Arnold - Croswell, MI
Arnold - Halls, TN
Arnold Afb - Tullahoma, TN
Arnold Air Force Base - Tullahoma, TN
Arrowhead - Canadian, OK
Artesia Airport - Artesia, NM
Arthur - Arthur, ND
Arthur - Fayette, AL
Arthur Municipal - Arthur, NE
Asbury Park Airport - Asbury Park, NJ
Ashe Co - Jefferson, NC
Asheboro Municipal - Asheboro, NC
Asheville Regional Airport - Asheville, NC
Ashland Airport - Ashland, WI
Ashland Co - Ashland, OH
Ashland Mun-Parker - Ashland, OR
Ashland-Boyd Co - Ashland, KY
Ashland-Lineville - Ashland-Lineville, AL
Ashley - Morris, OK
Ashley Airport - Ashley, ND
Ashtabula Airport - Jefferson, OH
Ashtabula Co - Ashtabula, OH
Aspen Airport - Aspen, CO
Astoria Airport - Astoria, OR
Athens Airport - Athens, GA
Athens Municipal - Athens, TX
Atka Airport - Atka, AK
Atlanta - Atlanta, ID
Atlanta Municipal - Atlanta, MI
Atlantic City International Airport - Atlantic City, NJ
Atlantic Municipal Airport - Atlantic, IA
Atmautluak Airport - Atmautluak, AK
Atmore Municipal - Atmore, AL
Atoka Municipal - Atoka, OK
Atqasuk Airport - Atqasuk, AK
Attala County Airport - Kosciusko, MS
Atwood Lodge - Dellroy, OH
Atwood-Rawlins Co City-Co - Atwood, KS
Auburn Airport - Auburn, CA
Auburn Airport - Auburn, ME
Auburn Municipal Airport - Auburn, WA
Auburn-Opelika Airport - Auburn, AL
Audubon Co - Audubon, IA
Augusta - Augusta, MT
Augusta Airport - Augusta, ME
Augusta Municipal - Augusta, KS
Ault Field - Whidbey Island, WA
Aurora Airport - Aurora, CO
Aurora Memorial Municipal - Aurora, MO
Aurora Municipal - Aurora, NE
Aurora Municipal Airport - Aurora, IL
Aurora State - Aurora, OR
Austin Airport - Austin, MN
Austin Airport - Austin, NV
Austin Lake - Kalamazoo, MI
Austin Straubel International Airport - Green Bay, WI
Austin-Bergstrom International Airport - Austin, TX
Autauga Co - Prattville, AL
Ava Martin Memorial - Ava, MO
Avalon Bay Airport - Catalina Island, CA
Avalon Vor/WP Airport - Catalina Island, CA
Avery Co - Spruce Pine, NC
Avey Field State - Laurier, WA
Avi Suquilla - Parker, AZ
Avon Park Municipal Airport - Avon Park, FL
Avra Valley Airport - Tucson, AZ
Aztec Municipal - Aztec, NM
Babb - Babb, MT
Baca Grande Airport - Baca Grande, CO
Backus Municipal - Backus, MN
Bacon Co - Alma, GA
Badami Airstrip - Badami, AK
Bader Field - Atlantic City, NJ
Bagdad Airport - Bagdad, AZ
Bagley Municipal - Bagley, MN
Bailes - Angleton, TX
Baker - Baker, CA
Baker - Hohenwald, TN
Baker - Millington, TN
Baker Airport - Baker, OR
Baker Army Air Field - Baker Island, AK
Baker Municipal - Baker, MT
Bakersfield Municipal - Bakersfield, CA
Bald Knob Municipal - Bald Knob, AR
Baldwin County Airport - Milledgeville, GA
Baldwin Municipal - Baldwin, MI
Baltimore Airpark - Baltimore, MD
Baltimore Greenbelt T Station - Baltimore, MD
Baltimore/Wash International Thurgood Marshall Airport - Baltimore, MD
Bamberg Co - Bamberg, SC
Bancroft Municipal - Bancroft, ID
Bandel - Eighty Four, PA
Bandera State - Bandera, WA
Bandit Field Airdrome - Clyde, OH
Bangor International Airport - Bangor, ME
Banning Airport - Banning, CA
Bar Harbor Airport - Bar Harbor, ME
Baraboo Wisconsin Dells - Baraboo, WI
Barber - Alliance, OH
Barbers Point Naval Station - Barbers Point, HI
Barin Olf Osn Airport - Foley, AL
Barking Sands Airport - Kekaha, HI
Barkley Regional Airport - Paducah, KY
Barksdale Air Force Base - Shreveport, LA
Barnes Airport - Hartford, CT
Barnes Co Municipal - Valley City, ND
Barnesville Municipal - Barnesville, MN
Barnesville-Bradfield - Barnesville, OH
Barnett Memorial - Mt Morris, IL
Barnstable Airport - Hyannis, MA
Barnwell County Airport - Barnwell, SC
Barron Municipal - Barron, WI
Barstow - Midland, MI
Barstow-Daggett Airport - Daggett, CA
Barter Island Airport - Barter Island, AK
Bartlesville Airport - Bartlesville, OK
Bartlett Sea Plane Base - Gustavus, AK
Bartletts Airport - Bartletts, AK
Bartow Airport - Bartow, FL
Barwick-Lafayette - Lafayette, GA
Basin Creek - Basin Creek, AK
Basin Harbor - Vergennes, VT
Bass Memorial - Lumberton, MS
Batesville Municipal Airport - Batesville, AR
Baton Rouge Downtown Airport - Baton Rouge, LA
Battery Park City/North Cove Sea Plane Base - New York, NY
Battle Creek International Airport - Kalamazoo, MI
Baublitz Commercial - Brogue, PA
Baudette Airport - Baudette, MN
Baxley Municipal - Baxley, GA
Bay Bridge - Stevensville, MD
Bay City Airport - Bay City, TX
Bay County Airport - Panama City, FL
Bay Minette Municipal - Bay Minette, AL
Bayfield Co - Iron River, WI
Bayport - Bayport, NY
Baytown Airport - Baytown, TX
Beach - Beach, ND
Beach - Charlotte, MI
Beach City - Beach City, OH
Beale Air Force Base - Marysville, CA
Bean Blossom - New Lathrop, MI
Bear Creek - Mt Pleasant, NC
Bear Creek Airport - Bear Creek, AK
Bear Lake Co - Paris, ID
Bear Trap - Minidoka, ID
Bearce - Mount Ida, AR
Beatrice Municipal Airport - Beatrice, NE
Beatty Airport - Beatty, NV
Beaufort Co - Beaufort, SC
Beaumont Municipal Airport - Beaumont, TX
Beauregard Parish Airport - De Ridder, LA
Beaver Airport - Beaver, AK
Beaver Falls Airport - Beaver Falls, PA
Beaver I - Beaver I, MI
Beaver Inlet Sea Port - Beaver Inlet, AK
Beaver Marsh State - Beaver Marsh, OR
Beaver Municipal - Beaver, OK
Beaver Municipal - Beaver, UT
Beaver Ruin Heliport - Atlanta, GA
Beckley Airport - Beckley, WV
Bedford Co - Bedford, PA
Bedford Municipal - Bedford, IA
Beech Airport - Wichita, KS
Beeville Municipal - Beeville, TX
Beicker Ranch - Seguin, TX
Belfast Municipal - Belfast, ME
Belle Creek - Belle Creek, MT
Belle Fourche Municipal - Belle Fourche, SD
Belle Glade State - Belle Glade, FL
Belle Plaine Municipal - Belle Plaine, IA
Bellefontaine Municipal - Bellefontaine, OH
Bellefontaine Regional Airport - Bellefontaine, OH
Bellefonte - Bellefonte, PA
Belleville Municipal - Belleville, KS
Bellingham Airport - Bellingham, WA
Bellows Field - Waimanalo, HI
Belmond Municipal - Belmond, IA
Beloit - Beloit, WI
Beltzville - Lehighton, PA
Beluga Airport - Beluga, AK
Belzoni Municipal - Belzoni, MS
Bemidji Airport - Bemidji, MN
Benchmark - Benchmark, MT
Bend Municipal - Bend, OR
Bendigo - Tower City, PA
Benedum Airport - Clarksburg, WV
Benger - Friona, TX
Bennett - Salisbury, MD
Bennett - Weston, WV
Bennettsville Airport - Bennettsville, SC
Benson Municipal - Benson, AZ
Benson Municipal Airport - Benson, MN
Benton - Benton, KS
Benton - Redding, CA
Benton Co - Camden, TN
Benton Municipal - Benton, IL
Bentonville Municipal/Thaden - Bentonville, AR
Berkeley - Berkeley, CA
Berkeley Co - Moncks Corner, SC
Berlin Airport - Berlin, NH
Bermuda Dunes Airport - Palm Springs, CA
Bermudian Valley - Kralltown, PA
Bernard Usfs - Bernard, ID
Berrien Co - Nashville, GA
Berry Hill - Stockbridge, GA
Berz-Macomb Airport - Utica, MI
Bessemer - Bessemer, AL
Bethany Memorial - Bethany, MO
Bethel Airport - Bethel, AK
Bethel City Landing - Bethel, AK
Bettles Airport - Bettles, AK
Betz - Blissfield, MI
Beulah - Beulah, ND
Beverly Municipal Airport - Beverly, MA
Bibb Co - Centreville, AL
Bicycle Lake Army Air Field - Fort Irwin, CA
Biddeford Municipal - Biddeford, ME
Big Bear City Airport - Big Bear, CA
Big Creek - Big Creek, ID
Big Creek Airport - Big Creek, AK
Big Falls Municipal - Big Falls, MN
Big Foot - Walworth, WI
Big Lake Airport - Big Lake, AK
Big Mountain Airport - Big Mountain, AK
Big Piney-Marbleton Airport - Big Piney, WY
Big Rapids Airport - Big Rapids, MI
Big Sandy - Big Sandy, MT
Big Sky - Culbertson, MT
Big Sky Airport - Ennis, MT
Big Southern Butte - Atomic City, ID
Big Spring Mc Mahon-Wrinkle - Big Spring, TX
Big Timber - Big Timber, MT
Bigfork Municipal - Bigfork, MN
Biggs Army Air Field - El Paso, TX
Bill and Hillary Clinton National Airport - Little Rock, AR
Billings Airport - Billings, MT
Biloxi Regional Airport - Gulfport, MS
Binghamton Airport - Binghamton, NY
Birch Creek Airport - Birch Creek, AK
Birchwood Airport - Birchwood, AK
Birchwood-Pocono Airport - East Stroudsburg, PA
Bird'S Nest - Austin, TX
Birmingham-Shuttlesworth International Airport - Birmingham, AL
Bisbee Municipal Airport - Bisbee, AZ
Bisbee-Douglas International Airport - Douglas, AZ
Bishop Airport - Bishop, CA
Bishop Airport - Flint, MI
Bishop Municipal - Bishop, TX
Bismarck Airport - Bismarck, ND
Bismarck Memorial - Bismarck, MO
Bison Municipal - Bison, SD
Black Hills Airport - Spearfish, SD
Black Memorial - Halls Crossing, UT
Black Mountain - Cheboygan, MI
Black Rapids - Black Rapids, AK
Black River Falls Area - Black River Falls, WI
Black Rock - Zuni Pueblo, NM
Blacker Airport - Manistee, MI
Blackhawk - Madison, WI
Blackstone Army Air Field - Blackstone, VA
Blackwell - Ozark, AL
Blackwell Airport - Blackwell, OK
Bladenboro - Bladenboro, NC
Blaine Airport - Blaine, WA
Blair - Blair, WI
Blairstown - Blairstown, NJ
Blairsville - Blairsville, GA
Blairsville Airport - Blairsville, PA
Blake - Delta, CO
Blakely Island Airport - Blakely Island, WA
Blanca - Blanca, CO
Blanding Airport - Blanding, UT
Block Island Airport - Block Island, RI
Bloom - Jamestown, OH
Bloomfield Municipal - Bloomfield, IA
Bloomfield Municipal - Bloomfield, NE
Bloomington Airport - Bloomington, IN
Bloomington-Normal Airport - Bloomington-Normal, IL
Bloomsburg Municipal - Bloomsburg, PA
Blosser Municipal Airport - Concordia, KS
Bloyer - Tomah, WI
Blue Canyon Airport - Blue Canyon, CA
Blue Earth Municipal - Blue Earth, MN
Blue Fox Bay Airport - Blue Fox Bay, AK
Blue Grass Airport - Lexington, KY
Blue Hill - Blue Hill, ME
Blue Knob Valley - Newry, PA
Blue Mountain Airport - Blue Mountain, AK 
Blue Ridge - Martinsville, VA
Blue Swan - Sayre, PA
Bluebird Hill - Keithville, LA
Bluff - Bluff, UT
Bluffton - Bluffton, OH
Blythe Airport - Blythe, CA
Blytheville Municipal Airport - Blytheville, AR
Boardman - Boardman, OR
Bob Barker Memorial Airport - Kiana, AK
Bob Hope Airport - Burbank, CA
Bob Sikes Airport - Crestview, FL
Bobby L. Chain Municipal Airport - Hattiesburg, MS
Boca Raton Airport - Boca Raton, FL
Boeing Field International Airport - Seattle, WA
Boerne Stage - San Antonio, TX
Bogue Mcalf - Swansboro, NC
Boire Field - Nashua, NH
Bois Blanc - Pointe Aux Pins, MI
Boise Air Terminal (Gowen Field) - Boise, ID
Boise City - Boise City, OK
Bolinder-Tooele Valley - Tooele, UT
Bolingbrook Med Center Heliport - Bolingbrook, IL
Bolivar Municipal - Bolivar, MO
Bolling Air Force Base - Washington, DC
Bollinger-Crass Memorial - Van Buren, MO
Bolton Field - Columbus, OH
Bomar Field - Shelbyville, TN
Bonnie - Rock, MI
Boone Airport - Boone, IA
Boone County Airport - Harrison, AR
Boone County Airport - Lebanon, IN
Booneville Municipal - Booneville, AR
Booneville/Baldwyn - Booneville/Baldwyn, MS
Boonville - Boonville, CA
Boonville - Boonville, IN
Bordelon - Breaux Bridge, LA
Bordner - Bowling Green, OH
Borger Airport - Borger, TX
Borges-Clarksburg Airport - Clarksburg, CA
Bornite Upper Airport - Bornite, AK
Borrego Springs Airport - Borrego Springs, CA
Boscobel - Boscobel, WI
Boston City Heliport - Boston, MA
Boswell Bay Airport - Boswell Bay, AK
Botsford - Wellington, OH
Bottineau Municipal - Bottineau, ND
Boulder - Boulder, MT
Boulder City Municipal Airport - Boulder City, NV
Boulder Junction - Boulder Junction, WI
Boulder Municipal Airport - Boulder, CO
Boundary Airport - Boundary, AK
Boundary Co - Bonners Ferry, ID
Bourland - Ft Worth, TX
Bowbells Municipal - Bowbells, ND
Bowdle Municipal - Bowdle, SD
Bowerman Airport - Hoquiam, WA
Bowers Field - Ellensburg, WA
Bowie - Bowie, AZ
Bowie Municipal - Bowie, TX
Bowling Green Municipal - Bowling Green, MO
Bowman - Anaconda, MT
Bowman - Livermore Falls, ME
Bowman Airport - Bowman, ND
Bowman Field - Louisville, KY
Bowstring - Deer River, MN
Boxborough Airport - Boxborough, MA
Boyceville Municipal - Boyceville, WI
Boylan State - Island Pond, VT
Boyne City Municipal - Boyne City, MI
Boyne Mtn - Boyne Falls, MI
Brackett Field - La Verne, CA
Bradenton Airport - Sarasota, FL
Bradford Airport - Bradford, PA
Bradford Co - Towanda, PA
Bradley International Airport - Hartford, CT
Bradley Sky Ranch - North Pole, AK
Bradshaw Army Air Field - Pohakuloa, HI
Brainard Airport - Hartford, CT
Branch Co Memorial - Coldwater, MI
Brand - Longmont, CO
Brandywine - West Chester, PA
Brandywine Hospital Heliport - Coatesville, PA
Branhams - Darlington, SC
Branson Airport - Hollister, MO
Brantley Co - Nahunta, GA
Brawley Municipal Airport - Brawley, CA
Braxton Co - Sutton, WV
Brazil Clay Co - Brazil, IN
Brazoria County Airport - Lake Jackson, TX
Breckinridge Co - Hardinsburg, KY
Bredlow Farm - England, AR
Bremerton National Airport - Bremerton, WA
Brenham Municipal - Brenham, TX
Brennand - Neenah, WI
Brenner - Falls City, NE
Bressler - Bird City, KS
Bresson - Compton, IL
Brevig Mission Airport - Teller Mission, AK
Brewer - Brewer, ME
Brewster Field - Holdrege, NE
Brewton Municipal - Brewton, AL
Bridgeport Municipal - Bridgeport, TX
Bridger Municipal - Bridger, MT
Bridgewater - Bridgewater, VA
Brigham City Airport - Brigham City, UT
Brighton - Brighton, MI
Britton Municipal Airport - Britton, SD
Broadus Airport - Broadus, MT
Brodhead - Brodhead, WI
Broken Bow - Broken Bow, OK
Broken Bow Municipal Airport - Broken Bow, NE
Brokenstraw - Pittsfield, PA
Broker Inn Airport - Boulder, CO
Brookbridge - Vaughn, GA
Brookeridge - Downers Grove, IL
Brookhaven Airport - Shirley, NY
Brookhaven-Lincoln Co - Brookhaven, MS
Brookings Airport - Brookings, SD
Brookings State Airport - Brookings, OR
Brooklandville Heliport - Brooklandville, MD
Brookneal-Campbell Co - Brookneal, VA
Brooks - Marshall, MI
Brooks Co - Falfurrias, TX
Brooks Lake Airport - Brooks Lake, AK
Brooks Lodge Airport - Brooks Lodge, AK
Brookville - Brookville, OH
Brooten Municipal - Brooten, MN
Brown County Airport - Georgetown, OH
Brown Field Municipal Airport - San Diego, CA
Browns Airport - Weeping Water, NE
Brownsville - Brownsville, CA
Brownwood Regional Airport - Brownwood, TX
Bruce - Ballinger, TX
Bruce Meadows - Stanley, ID
Brundidge Municipal - Brundidge, AL
Brunswick Co - Oak Island, NC
Brush Municipal - Brush, CO
Bryan - Starkville, MS
Bryant - Bridgeport, CA
Bryant Army Air Field - Fort Richardson, AK
Bryce Airport - Bryce, UT
Buchan - Englewood, FL
Buchanan Field - Concord, CA
Buckeye Airport - Buckeye, AZ
Buckland Airport - Buckland, AK
Buckley Air National Guard Base - Denver, CO
Bucklin - Bucklin, KS
Bucks - Bridgeton, NJ
Buffalo - Amarillo, TX
Buffalo Airfield - Buffalo, NY
Buffalo Municipal - Buffalo, MN
Buffalo Municipal - Buffalo, MO
Buffalo Municipal - Buffalo, OK
Buffalo Municipal Airport - Buffalo, WY
Buffalo Niagara International Airport - Buffalo, NY
Buffalo-Lancaster Regional Airport - Lancaster, NY
Buhl Municipal - Buhl, ID
Bullfrog Basin - Glen Canyon Natl Rec, UT
Bullfrog Basin Airport - Bullfrog Basin, UT
Bulverde - Bulverde, TX
Bunch'S Half Acre - Harrietta, MI
Bunkie Municipal - Bunkie, LA
Burke Co - Waynesboro, GA
Burke Lakefront Airport - Cleveland, OH
Burley Municipal Airport - Burley, ID
Burlington Airport - Burlington, IA
Burlington Airport - Burlington, MA
Burlington County Airport - Mount Holly, NJ
Burlington International Airport - Burlington, VT
Burlington Municipal - Burlington, WI
Burlington-Alamance Regional - Burlington, NC
Burnet Mun-Craddock - Burnet, TX
Burnett Co - Siren, WI
Burns Municipal Airport - Burns, OR
Bush Field - Augusta, GA
Butler Airport - Butler, MO
Butler County Regional Airport - Hamilton, OH
Butler Farm Show - Butler, PA
Butler Municipal - Butler, GA
Butler-Choctaw Co - Butler, AL
Butte Airport - Butte, MT
Butte Municipal - Palmer, AK
Butte Valley - Dorris, CA
Butter Valley Golf Port - Bally, PA
Butts Army Air Field - Colorado Springs, CO
Buzzards Point S Airport - Washington, DC
Buzzards Roost - Inola, OK
Byerley - Lake Providence, LA
Byron - Byron, CA
Cabaniss Field - Corpus Christi, TX
Cabin Creek Airport - Cabin Creek, AK
Cabin Creek Usfs - Big Creek Ranger Station, ID
Cable Airport - Upland, CA
Cable Heliport - Upland, CA
Cable Union - Cable, WI
Cabool Memorial - Cabool, MO
Cache Airport - Logan, UT
Cackleberry - Dexter, MI
Caddo Mills Municipal - Caddo Mills, TX
Cagney - Clio, MI
Cain - Stanwood, MI
Cairns Army Air Field - Ozark, AL
Cairo Airport - Cairo, IL
Cairo-Grady Co - Cairo, GA
Calaveras Co-Rasmussen - San Andreas, CA
Caldwell Industrial - Caldwell, ID
Caldwell Municipal - Caldwell, KS
Caldwell Municipal - Caldwell, TX
Calexico International Airport - Calexico, CA
Calhan - Calhan, CO
Calhoun Co - Blountstown, FL
Calhoun Co - Pittsboro, MS
Calhoun Co - Port Lavaca, TX
Calico Rock-Izard Co - Calico Rock, AR
California City Municipal - California City, CA
California Pines - Alturas, CA
Calipatria Airport - Calipatria, CA
Calkins - Wayland, MI
Callaway Gardens Airport - Callaway Gardens, GA
Calloway Airport - La Grange, GA
Calloway County Airport - Murray, KY
Camano I - Stanwood, WA
Camarillo Airport - Camarillo, CA
Camas Co - Fairfield, ID
Cambria County Airport - Johnstown, PA
Cambridge Airport - Cambridge, MD
Cambridge Municipal - Cambridge, MN
Cambridge Municipal - Cambridge, NE
Cambridge Municipal - Cambridge, OH
Camden Co - Berlin, NJ
Camden Municipal - Camden, AL
Camdenton Memorial - Camdenton, MO
Cameron - Angleton, TX
Cameron - Cameron Park, CA
Cameron Memorial - Cameron, MO
Cameron Municipal - Cameron, TX
Camilla-Mitchell Co - Camilla, GA
Camillus - Camillus, NY
Camp A P Hill Airport - Bowling Green, VA
Camp Blanding Aaf - Camp Blanding, FL
Camp Guernsey - Guernsey, WY
Camp Lake - Camp Lake, WI
Camp Maybry Army Heliport - Austin, TX
Camp McCoy Army Air Field - Sparta, WI
Camp Pendleton MCAS Airport - Oceanside, CA
Camp Vernon - Westfield, NY
Campbell - Copperhill, TN
Campbell - Grayslake, IL
Campbell - Madison, MS
Campbell Airport - Anchorage, AK
Campbell Army Airfield - Hopkinsville, KY
Campbell Co - Jacksboro, TN
Campbell County Airport - Gillette, WY
Campbell Municipal - Campbell, MO
Campbell Municipal - Indian River, MI
Campo Airport - Campo, CA
Canadian Lakes - Mecosta, MI
Canandaigua - Canandaigua, NY
Candle Airport - Candle, AK
Candlelight Farms - New Milford, CT
Cando Municipal - Cando, ND
Cannon Air Force Base - Clovis, NM
Canon City Airport - Canon City, CO
Canton Airport - Canton, SD
Canton-Hackney - Canton, TX
Canton-Plymouth-Mettetal - Plymouth, MI
Cantrell - Conway, AR
Cantwell - Cantwell, AK
Canyon Ferry - Townsend, MT
Canyonlands Field - Moab, UT
Cape Blanco State - Denmark, OR
Cape Canaveral As Skid Strip - Cocoa Beach, FL
Cape Cod - Marstons Mills, MA
Cape Girardeau Airport - Cape Girardeau, MO
Cape Lisburne Airport - Cape Lisburne, AK
Cape May County Airport - Wildwood, NJ
Cape Newenham Airport - Cape Newenham, AK
Cape Pole Airport - Cape Pole, AK
Cape Romanzof Airport - Cape Romanzof, AK
Cape Sabine - Cape Beaufort, AK
Cape Sarichef - Cape Sarichef, AK
Capital Airport - Springfield, IL
Capital City - Harrisburg, PA
Capital City Airport - Frankfort, KY
Capital City Airport - Harrisburg, PA
Capital City Airport - Lansing, MI
Capitol - Brookfield, WI
Carbon County Airport - Price, UT
Carey - Carey, ID
Caribou Municipal Airport - Caribou, ME
Carl R. Keller Field - Port Clinton, OH
Carleton Airport - Stanton, MN
Carlisle - Carlisle, PA
Carlisle Municipal - Carlisle, AR
Carlsbad Airport - Carlsbad, NM
Carmel Valley Vintage - Carmel Valley, CA
Carmi Municipal - Carmi, IL
Carnegie Municipal - Carnegie, OK
Caro Municipal - Caro, MI
Carrabelle - Pehrson, FL
Carrabelle-Thompson - Carrabelle, FL
Carriage Lane - Gregory, MI
Carrington Municipal - Carrington, ND
Carrizo Springs Airport - Carrizo Springs, TX
Carrizozo Municipal - Carrizozo, NM
Carroll - De Soto, TX
Carroll - Jackson, KY
Carroll Airport - Carroll, IA
Carroll Co - Berryville, AR
Carroll Co - Huntingdon, TN
Carroll Co Regional/Poage - Westminster, MD
Carroll Co-Tolson - Carrollton, OH
Carson City Airport - Carson City, NV
Carter - Pulaski, WI
Carter Memorial - Luling, TX
Cartersville - Cartersville, GA
Carthage - Carthage, IL
Carthage-Leake Co - Carthage, MS
Caruthersville Memorial - Caruthersville, MO
Casa De Aero Park - Hampshire, IL
Casa Grande Municipal Airport - Casa Grande, AZ
Cascabel - Tucson, AZ
Cascade - Cascade, ID
Cascade Locks/Stevens Airport - Cascade Locks, OR
Casco Cove Airport - Attu Island, AK
Casement Airport - Painesville, OH
Casey Municipal - Casey, IL
Cashmere-Dryden - Cashmere, WA
Casper Airport - Casper, WY
Casselton Regional - Casselton, ND
Cassville Municipal - Cassville, MO
Cassville Municipal - Cassville, WI
Castle Air Force Base - Merced, CA
Castroville Municipal - Castroville, TX
Caswell - Yanceyville, NC
Catalina Sea Plane Base - San Pedro, CA
Causey - Liberty, NC
Cavalier Municipal - Cavalier, ND
Cavanaugh Bay - Coolin, ID
Cawker City - Cawker City, KS
Cecil Co - Elkton, MD
Cecil Field Naval Air Station - Jacksonville, FL
Cedar Air Park - Olathe, KS
Cedar City Airport - Cedar City, UT
Cedar Mills - Gordonville, TX
Cedar Rapids Airport - Cedar Rapids, IA
Cedars North - Battle Ground, WA
Cedarville - Cedarville, CA
Centennial Airport - Denver, CO
Center Island Airport - Center Island, WA
Center Municipal - Center, TX
Centerport Heliport - Santa Ana, CA
Centerville Municipal - Centerville, IA
Centerville Municipal Airport - Centerville, TN
Central Airport - Central, AK
Central Business District Heliport - Houston, TX
Central City Municipal - Central City, NE
Central Co - Iola, WI
Central Colorado Regional - Buena Vista, CO
Central Maine Airport - Norridgewock, ME
Central Wisconsin Airport - Wausau, WI
Centralia Airport - Chehalis, WA
Centralia Municipal Airport - Centralia, IL
Centre Airpark - Centre Hall, PA
Centre Municipal - Centre, AL
Century City Airport - Los Angeles, CA
Cessna Aircraft Field - Wichita, KS
Chadron Airport - Chadron, NE
Chaffee Air Force Base - Fort Chaffee, AR
Chalet Suzanne - Lake Wales, FL
Chalkyitsik Airport - Chalkyitsik, AK
Challis Airport - Challis, ID
Chamberlain Municipal - Chamberlain, SD
Chamberlain Usfs - Chamberlain Guard Station, ID
Chambers Co-Winnie Stowell Airport - Winnie/Stowell, TX
Chambers County Airport - Anahuac, TX
Chambers Municipal - Lanett, AL
Chambersburg Municipal - Chambersburg, PA
Champion Executive - Orwell, OH
Chan Gurney Airport - Yankton, SD
Chandalar Airport - Chandalar, AK
Chandalar Shelf - Chandalar Camp, AK
Chandelle Estates - Dover, DE
Chandler Municipal - Chandler, AZ
Chandler Municipal - Chandler, OK
Chaplin - Cambridge, NY
Chariton Municipal - Chariton, IA
Charles City Municipal Airport - Charles City, IA
Charleston Executive - Charleston, SC
Charleston International Airport - Charleston, SC
Charleston Municipal - Charleston, MS
Charlevoix Municipal - Charlevoix, MI
Charlotte County Airport - Punta Gorda, FL
Charlotte Douglas International Airport - Charlotte, NC
Chase City Municipal - Chase City, VA
Chase Co - Cottonwood Falls, KS
Chase Field Naval Air Station - Beeville, TX
Chase Jr Memorial - Dover Foxcroft, ME
Chatham Municipal - Chatham, MA
Chatham Sea Plane Base - Chatham, AK
Chattanooga Sky Harbor - Chattanooga, OK
Cheboygan Co - Cheboygan, MI
Chefornak Sea Plane Base - Chefornak, AK
Chehalem - Newberg, OR
Chelan Municipal - Chelan, WA
Chemehuevi Valley - Chemehuevi Valley, CA
Chena Hot Springs Airport - Chena Hot Springs, AK
Chenega Bay - Chenega, AK
Chennault International - Lake Charles, LA
Cheraw Airport - Cheraw, SC
Chernofski Sea Plane Base - Chernofski, AK
Cherokee Co - Canton, GA
Cherokee Co - Jacksonville, TX
Cherokee Municipal - Cherokee, IA
Cherokee Municipal - Cherokee, OK
Cherokee Village Airport - Cherokee Village, AR
Cherry Ridge - Honesdale, PA
Cherry Springs - Galeton, PA
Chesapeake Regional - Chesapeake, VA
Chess-Lambertin Airport - Franklin, PA
Chester - Chester, CT
Chester Municipal - Chester, SC
Chestercounty Carlson Airport - Coatesville, PA
Chesterfield Co - Richmond, VA
Chetek Mun-Southworth - Chetek, WI
Chevak Airport - Chevak, AK
Cheyenne Airport - Cheyenne, WY
Cheyenne Co Municipal - St Francis, KS
Cheyenne Eagle Butte - Eagle Butte, SD
Chicago Midway International Airport - Chicago, IL
Chicago/Rockford International Airport - Rockford, IL
Chickasha Municipal Airport - Chickasha, OK
Chicken Airport - Chicken, AK
Chico Airport - Chico, CA
Chignik Bay Airport - Chignik, AK
Chignik Fisheries Airport - Chignik, AK
Chignik Lagoon Airport - Chignik, AK
Chignik Lake - Chignik Lake, AK
Chignik Lake Airport - Chignik, AK
Childress Airport - Childress, TX
Chilhowee - Benton, TN
Chillicothe Municipal - Chillicothe, MO
Chim Commercial - Minersville, PA
China Basin Heliport - San Francisco, CA
China Lake Naws - Ridgecrest, CA
Chinle Municipal - Chinle, AZ
Chino Airport - Chino, CA
Chippewa County Airport - Sault Ste. Marie, MI
Chiriaco Summit - Chiriaco, CA
Chisana Field - Chisana, AK
Chisholm Airport - Hibbing, MN
Chistochina Airport - Chistochina, AK
Chitina Airport - Chitina, AK
Chomley Airport - Chomley, AK
Chorman - Farmington, DE
Choteau - Choteau, MT
Chowchilla - Chowchilla, CA
Christmas Valley - Christmas Valley, OR
Chuathbaluk Airport - Chuathbaluk, AK
Church - Cresco, IA
Cimarron Municipal - Cimarron, KS
Cincinnati Blue Ash Airport - Cincinnati, OH
Cincinnati Municipal Airport - Cincinnati, OH
Cincinnati West Airport - Harrison, OH
Cincinnati/Northern Kentucky Airport - Cincinnati, OH
Cinder Park Airport - Cinder Park, AK
Cindy Guntly Memorial - Franksville, WI
Circle City Airport - Circle, AK
Circle Hot Springs Airport - Circle Hot Springs, AK
Circle Town Co - Circle, MT
Cisco Municipal - Cisco, TX
Citicorp Plaza Heliport - Los Angeles, CA
City And Co - Las Animas, CO
City Of Coalgate - Coalgate, OK
City of Industry Heliport - Los Angeles, CA
City Of-Swisher Co Municipal - Tulia, TX
City-Co - Gatesville, TX
Civic Ar Heliport - Pittsburgh, PA
Clare Co - Harrison, MI
Clare Municipal - Clare, MI
Claremont Municipal Airport - Claremont, NH
Claremore Regional - Claremore, OK
Clarence - Buffalo, NY
Clarendon Municipal - Clarendon, AR
Clarendon Municipal - Clarendon, TX
Clarinda Municipal Airport - Clarinda, IA
Clarion Co - Clarion, PA
Clarion Municipal - Clarion, IA
Clarissa Municipal - Clarissa, MN
Clark Co - Clark, SD
Clark Field - Stephenville, TX
Clark Memorial - Williams, AZ
Clark Regional Airport - Jeffersonville, IN
Clarke Co - Quitman, MS
Clarks Dream Strip - Circleville, OH
Clarks Point Airport - Clarks Point, AK
Clarksville Municipal - Clarksville, AR
Clarksville-Red River Co - Clarksville, TX
Claxton-Evans Co - Claxton, GA
Clay Center Municipal - Clay Center, KS
Clayton Municipal - Clayton, AL
Clayton Municipal Airpark - Clayton, NM
Cle Elum Municipal Airport - Cle Elum, WA
Clear Lake Airport - Clear Lake, CA
Clear Lake Municipal - Clear Lake, SD
Clear Sky Lodge - Clear, AK
Clearfield-Lawrence - Clearfield, PA
Clearview Airpark - Westminster, MD
Cleburne Municipal - Cleburne, TX
Clements Municipal - Bay City, MI
Clermont County Airport - Batavia, OH
Cleveland Hopkins International Airport - Cleveland, OH
Cleveland Municipal - Cleveland, MS
Cleveland Municipal - Cleveland, OK
Cleveland Municipal - Cleveland, TX
Clifton Municipal/Isenhower - Clifton, TX
Clinton - Clinton, IN
Clinton - Wilmington, OH
Clinton Airport - Clinton, IA
Clinton County Airport - Plattsburgh, NY
Clinton Field - Wilmington, OH
Clinton Memorial - Clinton, MO
Clinton Municipal - Clinton, AR
Clinton Municipal Airport - Clinton, OK
Clintonville Airport - Clintonville, WI
Clio Crop Care - Clio, SC
Cloquet Carlton Co - Cloquet, MN
Cloverdale Municipal - Cloverdale, CA
Clovis Municipal Airport - Clovis, NM
Clow International - Plainfield, IL
Cluck Ranch - Gruver, TX
Coal Creek - Yukon Charley Rivers, AK
Coalinga Airport - Coalinga, CA
Coast Guard Heliport - Point Retreat, AK
Coastal - Pensacola, FL
Coastal Carolina Regional Airport - New Bern, NC
Cobb Co-Mc Collum - Marietta, GA
Cochise Co - Willcox, AZ
Cochise College - Douglas, AZ
Cochran - Cochran, GA
Cochran - Morton, TX
Coeur D'Alene Airport - Coeur D'Alene, ID
Coffee Point Airport - Coffee Point, AK
Coffey Co - Burlington, KS
Coffeyville Municipal Airport - Coffeyville, KS
Coffield Airport - Rockdale, TX
Coffman Cove Sea Plane Base - Coffman Cove, AK
Cokeville Municipal - Cokeville, WY
Col Dyke - Bethel, ME
Colby Municipal Airport - Colby, KS
Cold Bay Airport - Cold Bay, AK
Cold Meadows Usfs - Cold Meadows Guard Station, ID
Coldfoot Airport - Coldfoot, AK
Cole Ranch - Sterling City, TX
Colebrook - Colebrook, NH
Coleman A. Young Municipal Airport - Detroit, MI
Coleman Airport - Coleman, TX
Coles County Memorial Airport - Mattoon, IL
Colfax - Colfax, LA
College Park Airport - College Park, MD
Collegedale Municipal - Collegedale, TN
Colonel James Jabara Airport - Wichita, KS
Colorado City - Colorado City, TX
Colorado City Municipal - Colorado City, AZ
Colorado Springs Airport - Colorado Springs, CO
Colorado Springs East - Ellicott, CO
Colstrip - Colstrip, MT
Columbia - Columbia, LA
Columbia Airport - Columbia Station, OH
Columbia Airport - Columbia, CA
Columbia County Airport - Hudson, NY
Columbia Metropolitan Airport - Columbia, SC
Columbia Regional Airport - Columbia, MO
Columbia-Adair Co - Columbia, KY
Columbia-Marion Co - Columbia, MS
Columbiana Co - East Liverpool, OH
Columbus - Columbus, MT
Columbus Air Force Base - Columbus, MS
Columbus Airport - Columbus, GA
Columbus Airport - Columbus, NE
Columbus Co Municipal - Whiteville, NC
Columbus Municipal - Columbus, ND
Columbus Municipal Airport - Columbus, IN
Columbus Municipal Airport - Columbus, NM
Columbus Southwest Airport - Columbus, OH
Colusa Co - Colusa, CA
Colville Municipal - Colville, WA
Comanche Co - Coldwater, KS
Comanche Co-City - Comanche, TX
Commerce Bus. Plaza Heliport - Los Angeles, CA
Commerce Municipal - Commerce, TX
Compton Airport - Compton, CA
Conchas State Park - Conchas Dam, NM
Concord - Painesville, OH
Concord Municipal Airport - Concord, NH
Concord Regional Airport - Concord, NC
Concordia Parish - Vidalia, LA
Concrete Municipal - Concrete, WA
Condon State Pauling - Condon, OR
Condon Usfs - Condon, MT
Condron Army Air Field - White Sands, NM
Connellsville - Connellsville, PA
Conrad - Conrad, MT
Convention Center Heliport - Oakland, CA
Converse - Converse, IN
Converse County Airport - Douglas, WY
Conway-Horry Co - Conway, SC
Cook Co - Adel, GA
Cook Municipal - Cook, MN
Coolidge Municipal - Coolidge, AZ
Cooperstown Airport - Cooperstown, NY
Cooperstown Municipal - Cooperstown, ND
Copalis State - Copalis, WA
Copeland - Ft Worth, TX
Copiah Co - Crystal Springs, MS
Copper Basin - Mackay, ID
Copper Centre Airport - Copper Centre, AK
Corbin-London Airport - London, KY
Corcoran Airport - Corcoran, CA
Cordell Municipal - Cordell, OK
Cordova City Airport - Cordova, AK
Cornelia Fort Airpark - Nashville, TN
Cornelius-Moore - Cedartown, GA
Cornell Municipal - Cornell, WI
Corner Bay Airport - Corner Bay, AK
Corning Municipal - Corning, AR
Corning Municipal - Corning, CA
Corning Municipal - Corning, IA
Corning-Painted Post - Corning, NY
Corona Municipal - Corona, CA
Coronado - Albuquerque, NM
Corporate - Pelion, SC
Corpus Christi International Airport - Corpus Christi, TX
Corry-Lawrence - Corry, PA
Corsica Municipal - Corsica, SD
Corsicana Airport - Corsicana, TX
Cortland Airport - Cortland, NY
Corvallis Municipal Airport - Corvallis, OR
Corydon - Corydon, IA
Costin - Port St Joe, FL
Cottage Grove State - Cottage Grove, OR
Cottonwood - Rockford, IL
Cottonwood Airport - Cottonwood, AZ
Cottonwood Municipal - Cottonwood, ID
Cotulla Airport - Cotulla, TX
Coulter Field - Bryan, TX
Council Bluffs Municipal Airport - Council Bluffs, IA
Council Municipal - Council, ID
Country Club - Goffstown, NH
Country Squire - Sandy, OR
County Airport - Beaufort, SC
County Airport - Jasper, TX
County Airport - Washington, PA
County Memorial - New Madrid, MO
County-Foster Airport - Victoria, TX
Coupeville Olf - Coupeville, WA
Cove Valley - Williamsburg, PA
Covington Municipal - Covington, GA
Covington Municipal - Covington, TN
Cowgill - Rio, WI
Cowley - Sandusky, MI
Cox Field - Paris, TX
Cox'S Well - Atomic City, ID
Cozad Municipal - Cozad, NE
Craft Air - Farmville, NC
Craig Air Force Base - Selma, AL
Craig Co South Grand Lake - Ketchum, OK
Craig Sea Plane Base - Craig, AK
Craig-Moffat Airport - Craig, CO
Craigmont Municipal - Craigmont, ID
Cram Field - Burwell, NE
Crandon Municipal - Crandon, WI
Crane County Airport - Crane, TX
Crane Island Airport - Crane Island, WA
Cranland - Hanson, MA
Crawford - Crawford, CO
Crawfordsville Municipal Airport - Crawfordsville, IN
Crazy Horse Municipal - Davis, OK
Creekside - Holcomb, NY
Creighton Municipal - Creighton, NE
Crescent Lake State - Crescent Lake, OR
Crescent Valley - Crescent Valley, NV
Crest - Kent, WA
Crested Butte Airport - Crested Butte, CO
Creston Municipal Airport - Creston, IA
Crete Municipal - Crete, NE
Creve Coeur Airport - St Louis, MO
Crewe Municipal - Crewe, VA
Crews Field - Raton, NM
Crisfield Municipal - Crisfield, MD
Crisp Co-Cordele - Cordele, GA
Crivitz Municipal - Crivitz, WI
Crooked Creek Airport - Crooked Creek, AK
Crookston Municipal Airport - Crookston, MN
Crooksville - Crooksville, OH
Crosby Municipal - Crosby, MS
Crosby Municipal - Crosby, ND
Crosbyton Municipal - Crosbyton, TX
Cross City Airport - Cross City, FL
Cross Keys - Cross Keys, NJ
Cross Winds - Clayton, WA
Crossett Municipal Airport - Crossett, AR
Crosson Field - Sterling, CO
Crossville Memorial Airport - Crossville, TN
Crow Wing County Airport - Brainerd, MN
Crownpoint - Crownpoint, NM
Crystal Airport - Minneapolis, MN
Crystal City Municipal - Crystal City, TX
Crystal Lake - Decatur, AR
Crystal Lake Airport - Crystal Lake, PA
Crystal River - Crystal River, FL
Cuba Municipal - Cuba, MO
Cube Cove Airport - Cube Cove, AK
Cuchara Valley Apt At La Veta - La Veta, CO
Cuddihy Field - Corpus Christi, TX
Cuero Municipal - Cuero, TX
Culberson County Airport - Van Horn, TX
Culmerville - Culmerville, PA
Culpeper Regional - Culpeper, VA
Cumberland Municipal - Cumberland, WI
Cummings Park Airport - Woburn, MA
Cure - Sunfield, MI
Currant Ranch - Currant, NV
Currituck Co - Currituck, NC
Curtis Field - Brady, TX
Curtis Memorial - Noorvik, AK
Curtis Memorial Airport - Noorvik, AK
Curtis Municipal - Curtis, NE
Cushing - Newark, IL
Cushing Municipal Airport - Cushing, OK
Custer - Monroe, MI
Custer Co - Custer, SD
Custer State Park - Fairburn, SD
Cut Bank Municipal Airport - Cut Bank, MT
Cuthbert-Randolph - Cuthbert, GA
Cuyahoga County Airport - Cleveland, OH
Cynthiana-Harrison Co - Cynthiana, KY
Cypress River - Jefferson, TX
Dabbs - Sumter, SC
Dacy - Harvard, IL
Dade Collier Training and Transition Airport - Miami, FL
Dahl Creek Airport - Dahl Creek, AK
Dale Delight - Postville, IA
Dalhart Airport - Dalhart, TX
Dallas Bay - Chattanooga, TN
Dallas Downtown Heliport - Dallas, TX
Dallas Executive Airport - Dallas, TX
Dallas Love Field - Dallas, TX
Dallas North Airport - Dallas, TX
Dallas/Fort Worth International Airport - Dallas, TX
Dalton - Flushing, MI
Dalton Municipal Airport - Dalton, GA
Danaher - Wichita Falls, TX
Danbury Airport - Danbury, CT
Dane County Regional Airport - Madison, WI
Danger Bay Airport - Danger Bay, AK
Daniel Field - Augusta, GA
Danielson - Danielson, CT
Dannelly Field - Montgomery, AL
Dansville Airport - Dansville, NY
Danville - Danville, PA
Danville Municipal - Danville, AR
Danville Municipal Airport - Danville, VA
Darby Dan Airport - Columbus, OH
Dare County Regional Airport - Manteo, NC
Darke Co - Versailles, OH
Darlington Co Jetport - Darlington, SC
Darrington Municipal - Darrington, WA
Dart - Mayville, NY
Dauphin I - Dauphin I, AL
Davenport - Davenport, WA
Davenport Airport - Davenport, IA
David - Calhoun, GA
David City Municipal - David City, NE
David Wayne Hooks Memorial Airport - Houston, TX
David'S - Athens, MI
David'S Landing - St Clair, MI
Davidson - Vermillion, SD
Davidson Co - Lexington, NC
Daviess Co - Washington, IN
Daviess County Airport - Owensboro, KY
Davis - Folkston, GA
Davis - Gates, OR
Davis - Laytonsville, MD
Davis Field - Muskogee, OK
Davis Monthan Air Force Base - Tucson, AZ
Davison Army Air Field - Fort Belvoir, VA
Dawson Aaf - Camp Dawson, WV
Dawson Community Airport - Glendive, MT
Dawson Municipal - Dawson, GA
Dayton Valley - Dayton/Carson City, NV
Dayton-New Lebanon - Dayton, OH
Dayton-Wright Brothers - Dayton, OH
Daytona Beach International Airport - Daytona Beach, FL
De Funiak Springs - De Funiak Springs, FL
De Kalb Co - Auburn, IN
De Kalb Taylor Municipal - De Kalb, IL
De Land Mun-Taylor - De Land, FL
De Quincy Industrial - De Quincy, LA
De Soto Parish - Mansfield, LA
De Vere Field - Cle Elum, WA
De Witt Municipal - De Witt, AR
Dean Memorial - Haverhill, NH
Death Valley Airport - Death Valley, CA
Deblois - Deblois, ME
Decatur Airport - Decatur, IL
Decatur County Airport - Bainbridge, GA
Decatur Hi-Way Airport - Decatur, IN
Decatur Island Airport - Decatur Island, WA
Decatur Municipal - Decatur, TX
Deck Airport - Myerstown, PA
Decker - Meno, OK
Decorah Municipal Airport - Decorah, IA
Deep Bay Airport - Deep Bay, AK
Deer Harbor Seaplane Airport - Orcas Island, WA
Deer Lodge-City-Co - Deer Lodge, MT
Deer Park - Deer Park, WA
Deer Park Airport - Deer Park, NY
Deering Airport - Deering, AK
Defiance Memorial Airport - Defiance, OH
Del Norte Mun-Co - Del Norte, CO
Del Rio International Airport - Del Rio, TX
Delano Municipal - Delano, CA
Delaware - Dover-Cheswold, DE
Delaware County Airport - Muncie, IN
Delaware Municipal - Delaware, OH
Delhi Municipal - Delhi, LA
Dell - Dell, MT
Dell City Municipal - Dell City, TX
Delphi Municipal - Delphi, IN
Delta Airport - Delta, UT
Delta County Airport - Escanaba, MI
Delta Junction Airport - Delta Junction, AK
Deming Airport - Deming, NM
Demopolis Municipal - Demopolis, AL
Denio Junction - Denio, NV
Denison Municipal Airport - Denison, IA
Denton - Denton, MT
Denton Municipal - Denton, TX
Denver City - Denver City, TX
Denver International Airport - Denver, CO
Derby Field - Lovelock, NV
Dermott Municipal - Dermott, AR
Des Moines International Airport - Des Moines, IA
Desert Aire - Mattawa, WA
Desert Center - Desert Center, CA
Desert Rock Airport - Mercury, NV
Deshler Municipal - Deshler, OH
Destin-Fort Walton Beach Airport - Destin, FL
Detroit Lakes Municipal Airport - Detroit Lakes, MN
Detroit Metropolitan Wayne County Airport - Detroit, MI
Detroit Naval Air Field - Mount Clemens, MI
Devils Lake Airport - Devils Lake, ND
Devils Track Airport - Grand Marais, MN
Devine Municipal - Devine, TX
Dew Memorial - Toronto, OH
Dew Station Airport - Lonely, AK
Dew Station Airport - Point Lay, AK
Dexter Municipal - Dexter, MO
Dexter Regional - Dexter, ME
Diamondhead - Diamondhead, MS
Dickinson Airport - Dickinson, ND
Dickson Municipal Airport - Dickson, TN
Dillant-Hopkins Airport - Keene, NH
Dilley - Dilley, TX
Dillingham Airfield - Oahu, HI
Dillingham Municipal Airport - Dillingham, AK
Dillon Airport - Dillon, MT
Dillon Airport - Dillon, SC
Dimmitt Municipal - Dimmitt, TX
Dinsmore - Dinsmore, CA
Dinwiddie County Airport - Petersburg, VA
Diomede Island Airport - Diomede Island, AK
Dixie Usfs - Dixie, ID
Dixon - Dixon, WY
Dixon Mun-Walgreen - Dixon, IL
Dobbins Air Force Base - Marietta, GA
Dobie'S - Inola, OK
Dodge Center - Dodge Center, MN
Dodge City Municipal Airport - Dodge City, KS
Dodge County Airport - Juneau, WI
Dolgeville - Dolgeville, NY
Dolomi Airport - Dolomi, AK
Dona Ana Co At Santa Teresa - Santa Teresa, NM
Donaldson Center Airport - Greenville, SC
Donalsonville Municipal - Donalsonville, GA
Donegal Springs - Mt Joy/Marietta, PA
Doniphan Municipal - Doniphan, MO
Donnelly - Donnelly, ID
Door County Airport - Sturgeon Bay, WI
Dora Bay Airport - Dora Bay, AK
Dothan Airport - Dothan, AL
Double Eagle Ii - Albuquerque, NM
Double Jj Resort Ranch - Rothbury, MI
Double Springs-Winston Co - Double Springs, AL
Dougherty County Airport - Albany, GA
Douglas County Airport - Minden, NV
Douglas Municipal - Douglas, GA
Douglas Municipal Airport - Douglas, AZ
Dove Creek - Dove Creek, CO
Dover Air Force Base - Dover-Cheswold, DE
Dowagiac Municipal - Dowagiac, MI
Downey - Downey, ID
Downey Heliport - Downey, CA
Downing - Coshocton, OH
Downtown - El Dorado, AR
Downtown - Springfield, MO
Doylestown Airport - Doylestown, PA
Dr. Haines Airport - Three Rivers, MI
Drake - Radcliffe, IA
Draughon-Miller Airport - Temple, TX
Drayton Municipal - Drayton, ND
Drift River Airport - Drift River, AK
Driggs-Reed Memorial Airport - Driggs, ID
Drummond Airport - Drummond, MT
Drummond Island Airport - Drummond Island, MI
Ds Butler Farm And Airfield - Oak Ridge, NC
Duanesburg Airport - Duanesburg, NY
Dublin Municipal - Dublin, TX
Dublin Municipal Airport - Dublin, GA
Dubois Airport - Dubois, ID
Dubois Municipal - Dubois, WY
Dubuque Municipal Airport - Dubuque, IA
Duchesne Municipal - Duchesne, UT
Duckwater - Duckwater, NV
Duford - Genesee, MI
Duke Field - Valparaiso, FL
Duluth International Airport - Duluth, MN
Dundee Flying Club - Dundee, NY
Dunkirk Airport - Dunkirk, NY
Dunn - Titusville, FL
Dunnellon - Dunnellon/Marion Co & Park Of*, FL
Dunsmuir Mun-Mott - Dunsmuir, CA
Dupage County Airport - Chicago, IL
Duplin Co - Kenansville, NC
Dupont-Lapeer - Lapeer, MI
Dupree Municipal - Dupree, SD
Dutch Harbor Airport - Dutch Harbor, AK
Dutch John - Dutch John, UT
Dutchess County Airport - Poughkeepsie, NY
Dutton - Dutton, MT
Duval-Freer - Freer, TX
Dwight - Dwight, IL
Dyer - Dyer, NV
Dyersburg Municipal - Dyersburg, TN
Dyess Air Force Base - Abilene, TX
Eads Municipal - Eads, CO
Eagle Airpark - Bullhead City, AZ
Eagle Airport - Eagle, AK
Eagle County Airport - Vail, CO
Eagle Creek Airpark - Indianapolis, IN
Eagle Grove Municipal - Eagle Grove, IA
Eagle Lake Airport - Eagle Lake, TX
Eagle River Airport - Eagle River, WI
Eagle'S Nest - Waynesboro, VA
Eagles Nest - West Creek, NJ
Eagleville - Eagleville, CA
Eaker Airport - Durant, OK
Earl Fields Memorial Airport - Poplar Bluff, MO
Earlville - Earlville, IL
Early Co - Blakely, GA
Easom - Newton, MS
East 34th Street - Sea Plane Base - New York, NY
East 34th Street Heliport - New York, NY
East 60th Street Heliport - New York, NY
East Cooper - Mt Pleasant, SC
East Gull Lake - East Gull Lake, MN
East Hampton Airport - East Hampton, NY
East Jordan City - East Jordan, MI
East Kansas City - Grain Valley, MO
East Troy Municipal - East Troy, WI
Eastern Oregon Regional Airport - Pendleton, OR
Easterwood Field - College Station, TX
Eastland Municipal Airport - Eastland, TX
Easton - Easton, PA
Easton - Greeley, CO
Easton Airport - Easton, MD
Eastport Municipal - Eastport, ME
Eaton Airport - Norwich, NY
Eau Claire Airport - Eau Claire, WI
Eau Claire Lakes - Drummond, WI
Ebensburg - Ebensburg, PA
Echo - Morris, PA
Echo Bay - Overton, NV
Eckert - Strathmore, CA
Edenton Municipal Airport - Edenton, NC
Edgar Co - Paris, IL
Edgefield Co - Trenton, SC
Edgeley Municipal - Edgeley, ND
Edgemont Municipal - Edgemont, SD
Edinburg International - Edinburg, TX
Edna Bay Airport - Edna Bay, AK
Edward F Knapp State Airport - Montpelier, VT
Edwards Af Aux North Base - Edwards, CA
Edwards Air Force Base - Edwards Air Force Base, CA
Edwards Co - Rocksprings, TX
Eek Airport - Eek, AK
Effingham Co Memorial - Effingham, IL
Egegik Airport - Egegik, AK
Eielson Air Force Base - Fairbanks, AK
Eight Fathom Bight Airport - Eight Fathom Bight, AK
Ekalaka - Ekalaka, MT
Ekuk Airport - Ekuk, AK
Ekwok Airport - Ekwok, AK
El Cajon Airport - El Cajon, CA
El Coyote Ranch - Encino, TX
El Dorado Airport - El Dorado, KS
El Dorado Springs Memorial - El Dorado Springs, MO
El Monte Airport - El Monte, CA
El Paso International Airport - El Paso, TX
El Reno - El Reno, OK
El Toro Marine Corps Air Station - Santa Ana, CA
Elbert Co-Patz - Elberton, GA
Elbow Lake Municipal - Elbow Lake, MN
Eldon Model - Eldon, MO
Eldora Municipal - Eldora, IA
Eldorado - Eldorado, TX
Elfin Cove Sea Plane Base - Elfin Cove, AK
Elgin Municipal - Elgin, ND
Elim Airport - Elim, AK
Elizabeth City Airport - Elizabeth City, NC
Elizabeth Field - Fishers Island, NY
Elizabethton Municipal - Elizabethton, TN
Elizabethtown - Elizabethtown, NC
Elizabethtown Airport - Elizabethtown, KY
Elk City - Elk City, ID
Elk City Municipal Airport - Elk City, OK
Elk Co - Moline, KS
Elk Hills-Buttonwillow - Buttonwillow, CA
Elkader - Elkader, IA
Elkhart Municipal Airport - Elkhart, IN
Elkhart-Morton Co - Elkhart, KS
Elkin Municipal - Elkin, NC
Elkins Airport - Elkins, WV
Elko Airport - Elko, NV
Ellamar Airport - Ellamar, AK
Ellendale Municipal - Ellendale, ND
Ellington Airport - Ellington, CT
Ellington Airport - Lewisburg, TN
Ellington Field - Houston, TX
Ellinwood Municipal - Ellinwood, KS
Elliotts Landing - Mt Victory, OH
Ellis Field - Mekoryuk, AK
Ells-Willits Municipal - Willits, CA
Ellsworth Air Force Base - Rapid City, SD
Ellsworth Municipal - Ellsworth, KS
Ellyson Naval Air Station - Pensacola, FL
Elma Municipal - Elma, WA
Elmdale - Abilene, TX
Elmendorf Air Force Base - Anchorage, AK
Elmira Regional Airport - Elmira, NY
Eloy Municipal - Eloy, AZ
Elroy Municipal - Elroy, WI
Elwood - Elwood, IN
Ely Airport - Ely, MN
Elyria Airport - Elyria, OH
Emanuel Co - Swainsboro, GA
Embarcadero - San Francisco, CA
Emeryville Heliport - Emeryville, CA
Emmet County Airport - Pellston, MI
Emmetsburg Municipal - Emmetsburg, IA
Emmett Municipal - Emmett, ID
Emmonak Airport - Emmonak, AK
Empire - Empire, MI
Empire - Empire, NV
Emporia Airport - Emporia, KS
Emporia-Greensville Regional - Emporia, VA
Enid Woodring Municipal Airport - Enid, OK
Enix Boys - Hennessey, OK
Ennis Municipal - Ennis, TX
Ennis-Big Sky - Ennis, MT
Enterprise Municipal - Enterprise, OR
Enterprise Municipal Airport - Enterprise, AL
Ephraim Fish Creek - Ephraim, WI
Ephrata Airport - Ephrata, WA
Eppley Airfield - Omaha, NE
Erie - Erie, IL
Erie - Erie, MI
Erie Co - Wattsburg, PA
Erie International Airport - Erie, PA
Errol Airport - Errol, NH
Escalante Municipal - Escalante, UT
Esler Field - Alexandria, LA
Espanola Airport - Espanola, NM
Essex County Airport - Caldwell, NJ
Essex Skypark - Baltimore, MD
Estancia Municipal - Estancia, NM
Estherville Municipal Airport - Estherville, IA
Estrella Sailport - Maricopa, AZ
Eufaula Municipal - Eufaula, OK
Eugene Airport - Eugene, OR
Eunice - Eunice, NM
Eunice Airport - Eunice, LA
Eupora - Eupora, MS
Eureka - Eureka, MT
Eureka Airport - Eureka, NV
Eureka Creek - Eureka Creek, AK
Eureka Municipal - Eureka, CA
Eureka Municipal - Eureka, KS
Eureka Municipal - Eureka, SD
Eutaw Municipal - Eutaw, AL
Evadale Landing Strip - Evadale, TX
Evanston Airport - Evanston, WY
Evansville Regional Airport - Evansville, IN
Evart Municipal - Evart, MI
Eveleth Airport - Eveleth, MN
Everett-Stewart Airport - Union City, TN
Everglades Airpark - Everglades, FL
Evergreen Field - Vancouver, WA
Excelsior Springs Memorial Airport - Excelsior Springs, MO
Excursion Inlet Sea Plane Base - Excursion Inlet, AK
Executive Airport - Clearwater, FL
Exeter - Exeter, CA
Express Airport - Toledo, OH
Fabens - Fabens, TX
Fair Haven Municipal - Fair Haven, VT
Fairbanks International Airport - Fairbanks, AK
Fairbury Municipal Airport - Fairbury, NE
Fairchild Air Force Base - Spokane, WA
Fairchild International Airport - Port Angeles, WA
Fairfield - Fairfield, MT
Fairfield Co - Lancaster, OH
Fairfield Co - Winnsboro, SC
Fairfield Municipal - Fairfield, IL
Fairfield Municipal Airport - Fairfield, IA
Fairgrounds - Hardin, MT
Fairhope Municipal - Fairhope, AL
Fairmont Airport - Fairmont, MN
Fairmont Mun-Frankman - Fairmont, WV
Fairmont State - Fairmont, NE
Fairview - Fairview, MT
Fairview - Landrum, SC
Fairview Municipal - Fairview, OK
Faith Municipal - Faith, SD
Falcon Field - Mesa, AZ
Falconhead - Burneyville, OK
Fall River Mills - Fall River Mills, CA
Fallbrook Community - Fallbrook, CA
Fallon Municipal Airport - Fallon, NV
Falls Bay Airport - Falls Bay, AK
Falls International Airport - International Falls, MN
Fallston - Fallston, MD
Falmouth - Falmouth, MA
False Island Airport - False Island, AK
False Pass Airport - False Pass, AK
False River - New Roads, LA
Falwell - Lynchburg, VA
Fanning Field - Idaho Falls, ID
Far View - Hiram, OH
Farewell Airport - Farewell, AK
Faribault Municipal Airport - Faribault, MN
Farmers Pride - Fredericksburg, PA
Farmerville - Farmerville, LA
Farmington Municipal Airport - Farmington, NM
Farmington Regional Airport - Farmington, MO
Farmville Regional - Farmville, VA
Farnsworths - North Rose, NY
Faulkton Municipal - Faulkton, SD
Fayette - Fayetteville, WV
Fayette Co - Somerville, TN
Fayette Co - Washington Court House, OH
Fayette Regional Air Center - La Grange, TX
Fayetteville Municipal Airport (Drake Field) - Fayetteville, AR
Fayetteville Municipal Airport - Fayetteville, NC
Fayetteville Municipal Airport - Fayetteville, TN
Feather River - Feather River, AK
Federer Memorial - Brinkley, AR
Fehmel Dusting Service - Bay City, TX
Felker Army Air Field - Fort Eustis, VA
Felt - Roseburg, OR
Felts Field - Spokane, WA
Fentress Nalf - Fentress, VA
Fergus Falls Airport - Fergus Falls, MN
Ferguson - Pensacola, FL
Fernandina Beach Municipal - Fernandina Beach, FL
Ferndale - Big Fork, MT
Ferry Co - Republic, WA
Fertile Municipal - Fertile, MN
Fessenden Municipal - Fessenden, ND
Festus Memorial Airport - Festus, MO
Field Of Dreams - Hale, MI
Fillmore Co - Preston, MN
Fillmore Municipal Airport - Fillmore, UT
Fin Creek Airport - Fin Creek, AK
Findlay Airport - Findlay, OH
Finger Lakes Regional - Seneca Falls, NY
Finleyville - Finleyville, PA
Fire Cove Airport - Fire Cove, AK
Firebaugh - Firebaugh, CA
Firing Center Army Air Field - Yakima, WA
First Flight Airport - Kill Devil Hills, NC
Firstair - Monroe, WA
Fish Lake Usfs - Fish Lake, ID
Fisher Co - Rotan/Roby, TX
Fitchburg Municipal - Fitchburg, MA
Fitzgerald Municipal - Fitzgerald, GA
Five Fingers Airport - Five Fingers, AK
Five Mile Airport - Five Mile, AK
Flagler Co - Bunnell, FL
Flagstaff Pulliam Airport - Flagstaff, AZ
Flanagan - Farmville, NC
Flandreau Municipal - Flandreau, SD
Flat Airport - Flat, AK
Flat Top Ranch - Walnut Springs, TX
Flaxman Island Airport - Flaxman Island, AK
Fleming-Mason - Flemingsburg, KY
Fletcher Field - Clarksdale, MS
Flippin Airport - Flippin, AR
Flora Municipal - Flora, IL
Flora Municipal - Flora, IN
Florala Municipal - Florala, AL
Florence Airport - Florence, SC
Florence Memorial - Arkadelphia, AR
Florence Municipal - Florence, OR
Floydada Municipal - Floydada, TX
Flushing Airport - New York, NY
Fly For Fun - Vancouver, WA
Flyin Tiger Airport - Angleton, TX
Flyin' B Airport - Houston, TX
Flying A - Chatfield, MN
Flying Bar H Ranch - Springfield, MO
Flying Cloud Airport - Minneapolis, MN
Flying Dollar - Canadensis, PA
Flying J Ranch - Pima, AZ
Flying M Aerodrome - Germansville, PA
Flying Ten - Archer, FL
Flying U Ranch - Union Mills, IN
Flying V - Utica, NE
Flying V Ranch - Louise, TX
Flying W - Lumberton, NJ
Flying W - Potters Hill, NC
Flying-A-Ranch - Fruitport, MI
Foard Co - Crowell, TX
Foley Municipal - Foley, AL
Follett-Lipscomb Co - Follett, TX
Folsom - Cullman, AL
Folsom - Elba, AL
Fond Du Lac Airport - Fond Du Lac, WI
Forbes Field - Topeka, KS
Ford Airport - Iron Mountain, MI
Forest City Municipal Airport - Forest City, IA
Forest Hill - Westphalia, MI
Forest Lake - Forest Lake, MN
Forks - Forks, WA
Forney Army Air Field - Fort Leonard Wood, MO
Forrest City Municipal Airport - Forrest City, AR
Fort Bragg Airport - Fort Bragg, CA
Fort Bridger Airport - Fort Bridger, WY
Fort Collins/Loveland Municipal Airport - Fort Collins/Loveland, CO
Fort Dodge Airport - Fort Dodge, IA
Fort Hood Army Air Field - Killeen, TX
Fort Huachuca/Sierra Vista Municipal Airport - Fort Huachuca/Sierra Vista, AZ
Fort Jefferson Airport - Fort Jefferson, FL
Fort Lauderdale Executive Airport - Fort Lauderdale, FL
Fort Lauderdale-Hollywood International Airport - Fort Lauderdale, FL
Fort Lee Army Air Field - Petersburg, VA
Fort Madison Municipal Airport - Fort Madison, IA
Fort Scott Municipal Airport - Fort Scott, KS
Fort Smith Municipal Airport - Fort Smith, AR
Fort Sumner Airport - Fort Sumner, NM
Fort Wainwright Airport - Fairbanks, AK
Fort Wayne International Airport - Fort Wayne, IN
Fort Worth Alliance Airport - Fort Worth, TX
Fort Worth Meacham International Airport - Fort Worth, TX
Fort Worth Naval Air Station - Fort Worth, TX
Fort Yukon Airport - Fort Yukon, AK
Fortuna Ledge Airport - Fortuna Ledge, AK
Fosston Municipal - Fosston, MN
Foster - Apple River, IL
Fostoria Metropolitan - Fostoria, OH
Fountainhead Lodge - Eufaula, OK
Fowler - Fowler, KS
Fox Airport - Fox, AK
Fox River - Rochester, WI
Franconia - Franconia, NH
Frankfort - Frankfort, IL
Frankfort Dow Memorial - Frankfort, MI
Frankfort Municipal - Frankfort, IN
Frankfort-Highland - Utica/Frankfort, NY
Franklin - Franklin, CA
Franklin - Union Springs, AL
Franklin Co - Canon, GA
Franklin Co - Mt Vernon, TX
Franklin Co State - Highgate, VT
Franklin County Airport - Sewanee, TN
Franklin Flying Field - Franklin, IN
Franklin Municipal Airport - Franklin, VA
Franklin-Wilkins - Lexington, TN
Franklinton - Franklinton, LA
Frasca - Urbana, IL
Frederick Municipal Airport - Frederick, MD
Frederick Municipal Airport - Frederick, OK
Fredericktown Regional - Fredericktown, MO
Fredonia - Fredonia, KS
Free Municipal - Dumas, AR
Freedom - Freedom, OH
Freehold - Freehold, NY
Freeman - Junction City, KS
Freeman Municipal Airport - Seymour, IN
Freeport/Dornink - Freeport, IL
Freeway - Mitchellville, MD
Fremont Airport - Fremont, OH
Fremont Municipal - Fremont, MI
Fremont Municipal Airport - Fremont, NE
French Lick Municipal Airport - French Lick, IN
French Valley Airport - Rancho, CA
Frenchville Airport - Frenchville, ME
Fresh Water Bay Airport - Fresh Water Bay, AK
Fresno Yosemite International Airport - Fresno, CA
Fresno-Chandler Airport - Fresno, CA
Friday Harbor Airport - Friday Harbor, WA
Friday Harbor SPB - Friday Harbor, WA
Frisco - Frisco, TX
Fritzche Army Air Field - Monterey, CA
Front Range Airport - Denver, CO
Fryeburg Airport - Fryeburg, ME
Ft Atkinson Municipal - Ft Atkinson, WI
Ft Belknap Agency - Harlem, MT
Ft Benton - Ft Benton, MT
Ft Bidwell - Ft Bidwell, CA
Ft Collins Downtown - Ft Collins, CO
Ft Deposit-Lowndes Co - Ft Deposit, AL
Ft Morgan Municipal - Ft Morgan, CO
Ft Ruby Ranch - Ruby Valley, NV
Ft Smith - Ft Smith, MT
Ft Walton Beach - Navarre, FL
Ft Worth Spinks - Ft Worth, TX
Ft. Wolter Air Force Base - Mineral Wells, TX
Fuller - Milford, IA
Fullerton Municipal Airport - Fullerton, CA
Fulton - Fulton, KY
Fulton Co - Johnstown, NY
Fulton Co - Wauseon, OH
Fulton County Airport - Atlanta, GA
Fulton County Airport - Rochester, IN
Fulton International Airport - Akron/Canton, OH
Fulton-Itawamba Co - Fulton, MS
Funter Bay Sea Plane Base - Funter Bay, AK
Furnace Creek - Death Valley Natl Park, CA
Gabbs Airport - Gabbs, NV
Gackle Municipal - Gackle, ND
Gadsden Municipal Airport - Gadsden, AL
Gage Airport - Gage, OK
Gaines Co - Seminole, TX
Gainesville Memorial - Gainesville, MO
Gainesville Municipal Airport - Gainesville, TX
Gainesville Regional Airport - Gainesville, FL
Gakona Airport - Gakona, AK
Galbraith Lake Airport - Galbraith Lake, AK
Galena Airport - Galena, AK
Galesburg Airport - Galesburg, IL
Galion Airport - Galion, OH
Gallatin Field - Bozeman, MT
Galleria Heliport - Atlanta, GA
Gallia-Meigs Regional - Gallipolis, OH
Galt - Greenwood/Wonder Lake, IL
Galveston - Galveston, IN
Gambell Airport - Gambell, AK
Ganado - Ganado, AZ
Ganes Creek Airport - Ganes Creek, AK
Gansner - Quincy, CA
Garberville - Garberville, CA
Garden City Municipal Airport - Garden City, KS
Garden Harris County Airport - Pine Mountain, GA
Garden Valley - Garden Valley, ID
Gardiner - Gardiner, MT
Gardner Municipal Airport - Gardner, MA
Garfield County Airport - Rifle, CO
Garland - Lewiston, MI
Garn - Eagle Mountain, UT
Garner Field - Uvalde, TX
Garnsey'S - Schuylerville, NY
Garrison Dam Recreational - Riverdale, ND
Garrison Municipal - Garrison, ND
Gary Regional Airport - Gary, IN
Gaston - Lakeview, AR
Gastonia Municipal - Gastonia, NC
Gates - Garrettsville, OH
Gatlinburg Airport - Gatlinburg, TN
Gavagan - Yale, MI
Geauga Co - Middlefield, OH
Gebauer - Akron, CO
Gen Pershing Memorial - Brookfield, MO
Gen Spain - Memphis, TN
Gen-Air Park - Geneseo, IL
Gen. Wayne A. Downing Peoria International Airport - Peoria, IL
General Brees Field - Laramie, WY
General Lucius D. Clay National Guard Center - Marietta, GA
General Mitchell International Airport - Milwaukee, WI
Genesee Co - Batavia, NY
Geneseo - Geneseo, NY
Geneva Municipal - Geneva, AL
Genoa Municipal - Genoa, NE
George Bush Intercontinental Airport - Houston, TX
George Downer Airport - Aliceville, AL
George R. Carr Airport - Bogalusa, LA
Georgetown - Georgetown, CA
Georgetown Airport - Georgetown, SC
Georgetown Municipal - Georgetown, TX
Georgetown-Scott County Regional Airport - Georgetown, KY
Gerald R. Ford International Airport - Grand Rapids, MI
Geraldine - Geraldine, MT
Germack - Geneva, OH
Gettysburg Airport - Gettysburg, PA
Gettysburg Municipal - Gettysburg, SD
Gibson Co - Trenton, TN
Giddings-Lee Co - Giddings, TX
Gideon Memorial - Gideon, MO
Giermek Executive - Olean, NY
Gila Bend Municipal - Gila Bend, AZ
Gilbert Field Airport - Winter Haven, FL
Gillespie - Meddybemps, ME
Gillespie Co - Fredericksburg, TX
Gillespie Field - San Diego, CA
Gilmer Co - Ellijay, GA
Gilmore - Pleasanton, KS
Girdwood - Girdwood, AK
Glacier Creek Airport - Glacier Creek, AK
Glacier Park International Airport - Kalispell, MT
Gladewater Municipal - Gladewater, TX
Gladstone - Gladstone, MI
Gladwin Airport - Gladwin, MI
Glasgow International Airport - Glasgow, MT
Glasgow Municipal Airport - Glasgow, KY
Glen Ullin Municipal - Glen Ullin, ND
Glencoe Municipal - Glencoe, MN
Glendale Fokker Airport - Glendale, WV
Glendale Heliport - Glendale, CA
Glendale Municipal Airport - Glendale, AZ
Glenn County Airport - Willows, CA
Glenn L. Martin Airport - Baltimore, MD
Glennallen Airport - Glennallen, AK
Glenndale - Kokomo, IN
Glenns Ferry Municipal - Glenns Ferry, ID
Glenview Naval Air Station - Glenview, IL
Glenwood Municipal - Glenwood, MN
Glenwood Springs Municipal - Glenwood Springs, CO
Glenwood-Catron Co - Glenwood, NM
Glowacki - St Johns, MI
Glynco Jetport - Brunswick, GA
Godman Army Air Field - Fort Knox, KY
Goetz Co - Onaway, MI
Gogebic County Airport - Ironwood, MI
Goheen - Battle Ground, WA
Gold Horn SPB - Golden Horn, AK
Golden Triangle Regional Airport - Columbus, MS
Goldendale - Goldendale, WA
Goldfield - Goldfield, NV
Goldsboro-Wayne Municipal Airport - Goldsboro, NC
Golovin Airport - Golovin, AK
Gonzales Municipal - Gonzales, TX
Goodfellow Air Force Base - San Angelo, TX
Gooding Airport - Gooding, ID
Goodnews Bay Airport - Goodnews Bay, AK
Goodspeed - East Haddam, CT
Goodwin Field - El Dorado, AR
Goose Bay - Goose Bay, AK
Goose Creek - Indian Trail, NC
Gordon Airport - Gordon, NE
Gordonsville Municipal Airport - Gordonsville, VA
Gorham - Gorham, NH
Goshen Airport - Goshen, IN
Gowanda - Gowanda, NY
Gradolph - Petersburg, MI
Grafton Municipal - Grafton, ND
Gragg-Wade - Clanton, AL
Graham - North Sioux City, SD
Graham Field - Butler, PA
Graham Municipal - Graham, TX
Graham Usfs - Atlanta, ID
Granbury Municipal - Granbury, TX
Granby-Grand Co - Granby, CO
Grand Canyon Bar Ten - Whitmore, AZ
Grand Canyon Heliport - Grand Canyon, AZ
Grand Canyon National Park Airport - Grand Canyon, AZ
Grand Canyon State - Wellsboro, PA
Grand Canyon West Airport - Peach Springs, AZ
Grand Coulee Dam - Electric City, WA
Grand Forks Air Force Base - Red River, ND
Grand Forks Airport - Grand Forks, ND
Grand Geneva Resort - Lake Geneva, WI
Grand Glaize Airport - Osage Beach, MO
Grand Haven Memorial - Grand Haven, MI
Grand Island Airport - Grand Island, NE
Grand Isle Seaplane Base - Grand Isle, LA
Grand Junction Regional Airport - Grand Junction, CO
Grand Lake Regional - Afton, OK
Grand Marais - Grand Marais, MI
Grand Prairie Municipal Airport - Grand Prairie, TX
Grand Rapids Airport - Grand Rapids, MN
Grand Strand Airport - Myrtle Beach, SC
Grande Valley - Maricopa, AZ
Grandfield Municipal - Grandfield, OK
Grandpa'S Farm-Mendota - Mendota, IL
Granite Falls Municipal/Lenzen-Roe * - Granite Falls, MN
Granite Mountain Airport - Granite Mountain, AK
Grant - Grant, MI
Grant Co Municipal - Hyannis, NE
Grant County Airport - Moses Lake, WA
Grant County Airport - Petersburg, WV
Grant County Airport - Silver City, NM
Grant Municipal - Grant, NE
Grants Pass - Grants Pass, OR
Grantsburg Municipal Airport - Grantsburg, WI
Granville - Granville, NY
Grasmere - Grasmere, ID
Gratiot Community Airport - Alma, MI
Gravelly Valley - Upper Lake, CA
Grawunder - Bellville, TX
Gray Army Air Field - Killeen, TX
Gray Army Air Field - Tacoma, WA
Grayling Aaf - Grayling, MI
Grayling Airport - Grayling, AK
Grays Creek Airport - Fayetteville, NC
Grayson Co - Leitchfield, KY
Grayson County Airport - Sherman-Denison, TX
Great Barrington Airport - Great Barrington, MA
Great Bend Airport - Great Bend, KS
Great Falls International Airport - Great Falls, MT
Great Valley - Great Valley, NY
Greater Kankakee Airport - Kankakee, IL
Greater Morris Co - Daingerfield, TX
Greater Rochester International Airport - Rochester, NY
Greater St Tammany - Covington, LA
Greeley Municipal - Greeley, NE
Green Acres - Livingston, NY
Green Airport - Oaktown, IN
Green County Airport - Waynesburg, PA
Green Lake - Interlochen, MI
Green River Airport - Green River, UT
Green Sea - Green Sea, SC
Greenbrier Airport - White Sulphur Springs, WV
Greenbrier Valley Airport - Lewisburg, WV
Greenbush Municipal - Greenbush, MN
Greene - Greene, NY
Greene Co-Jackson Regional - Dayton, OH
Greene County Regional Airport - Greensboro, GA
Greenfield Municipal - Greenfield, IA
Greensboro Municipal - Greensboro, AL
Greensburg Jeannette Regional - Jeannette, PA
Greensburg-Decatur Co - Greensburg, IN
Greensfield Airport - Moscow Mills, MO
Greenville Airport - Greenville, MS
Greenville Downtown Airport - Greenville, SC
Greenville Municipal - Greenville, AL
Greenville Municipal - Greenville, ME
Greenville Municipal - Greenville, MI
Greenville Municipal - Greenville, PA
Greenville Municipal Airport - Greenville, IL
Greenville Municipal Airport - Greenville, TN
Greenville Seaplane Base - Greenville, ME
Greenville-Rainbow - Greenville, NY
Greenville-Spartanburg Airport - Greenville, SC
Greenway Plaza Heliport - Houston, TX
Greenwood Airport - Greenwood, SC
Greenwood Lake - West Milford, NJ
Greenwood Municipal Airport - Indianapolis, IN
Gregg County Airport - Longview, TX
Gregory Municipal - Gregory, SD
Grenada Municipal - Grenada, MS
Grenora Centennial - Grenora, ND
Grider Field - Pine Bluff, AR
Griffin Memorial - Wiggins, MS
Griffin Sandusky Airport - Sandusky, OH
Griffin-Spalding Co - Griffin, GA
Griffiss Air Force Base - Rome, NY
Griffith-Merrillville - Griffith, IN
Grimes - Bethel, PA
Grimes - Urbana, OH
Grinnell Regional - Grinnell, IA
Grissom Air Force Base - Peru, IN
Gross - Pinconning, MI
Grosse Ile Municipal Airport - Detroit, MI
Groton Municipal - Groton, SD
Groton-New London Airport - New London, CT
Grove - Camas, WA
Grove City - Grove City, PA
Grove Hill Municipal - Grove Hill, AL
Grove Municipal - Grove, OK
Grumman Airport - Bethpage, NY
Grund - Ithaca, NY
Grundman - Nebraska City, NE
Grundy Center Municipal - Grundy Center, IA
Grundy Municipal - Grundy, VA
Grutzmacher Municipal - Onaga, KS
Gruver Municipal - Gruver, TX
Grygla Mun-Wilkens - Grygla, MN
Gtr Green River Intergalactic* - Green River, WY
Gulkana Airport - Gulkana, AK
Gundys - Owasso, OK
Gunnison Airport - Gunnison, CO
Gunter Annex - Montgomery, AL
Guntersville Municipal - Guntersville, AL
Gurdon Lowe - Gurdon, AR
Gustavus Airport - Gustavus, AK
Gustine Airport - Gustine, CA
Guthrie Airport - Guthrie, OK
Guthrie Co Regional - Guthrie Center, IA
Gutzmer'S Twin Oaks - Whitewater, WI
Guymon Airport - Guymon, OK
Gwin - Bessemer, PA
Gwinner-Melroe - Gwinner, ND
Gwinnett Co-Briscoe - Lawrenceville, GA
Habersham Co - Cornelia, GA
Hacienda Business Park Heliport - Pleasanton, CA
Hackettstown - Hackettstown, NJ
Haddock - Erick, OK
Hadley - Round Mountain, NV
Hagerstown - Hagerstown, IN
Hahn Sky Ranch - West Bend, WI
Haigh - Orland, CA
Haines Municipal Airport - Haines, AK
Hains - Rayne, LA
Hale County Airport - Plainview, TX
Haley AAF - Fort Sheridan, IL
Half Moon Airport - Half Moon, CA
Halifax County Airport - Roanoke Rapids, NC
Hall-Miller Municipal - Atlanta, TX
Hallettsville Municipal - Hallettsville, TX
Halliburton Airport - Duncan, OK
Hallock Municipal - Hallock, MN
Hamburg Inc Airport - Hamburg, NY
Hamilton - Derby, KS
Hamilton Field - San Rafael, CA
Hamilton Municipal - Hamilton, NY
Hamilton Municipal - Hamilton, TX
Hamlin Municipal - Hamlin, TX
Hammond Northshore Regional Airport - Hammond, LA
Hammonton Municipal - Hammonton, NJ
Hamp - Elwell, MI
Hampton - Hampton, NH
Hampton Municipal - Hampton, AR
Hampton Municipal Airport - Hampton, IA
Hampton Roads - Chesapeake, VA
Hampton-Varnville - Hampton, SC
Hana Airport - Hana, HI
Hanchey Army Heliport - Ozark, AL
Hancock International Airport - Syracuse, NY
Hanford Municipal - Hanford, CA
Hanks - Kaplan, LA
Hanksville Intermediate Airport - Hanksville, UT
Hanley - Munising, MI
Hanna Airport - Hanna, WY
Hannibal Municipal - Hannibal, MO
Hanover - Hanover, PA
Hanover Co Municipal - Richmond/Ashland, VA
Hanscom Field - Bedford/Hanscom, MA
Hanus Bay Airport - Hanus Bay, AK
Happy Camp - Happy Camp, CA
Harbor Springs - Harbor Springs, MI
Harbour - Gravois Mills, MO
Hardin Co - Kenton, OH
Harding Co - Buffalo, SD
Hardwick - Cleveland, TN
Hardy-Anders Airport - Natchez, MS
Harford - Casper, WY
Harford Co - Churchville, MD
Hargrove - Stuttgart, AR
Harlan - Lagrange, OH
Harlan Municipal - Harlan, IA
Harlem - Harlem, MT
Harnett Regional Jetport - Erwin, NC
Harper Municipal - Harper, KS
Harrell Field - Camden, AR
Harriet Field - Wells, NV
Harriman And West - North Adams, MA
Harris Ranch - Coalinga, CA
Harrisburg International Airport - Middletown, PA
Harrison - Knox City, TX
Harrison Co - Cadiz, OH
Harrison County Airport - Marshall, TX
Harrison Skyranch - Harrison, NE
Harrisville - Harrisville, MI
Harrold - Butler, IN
Harrold Municipal - Harrold, SD
Harry Clever Airport - New Philadelphia, OH
Harry S. Truman Regional Airport - Bates City, MO
Harsens I - Harsens I, MI
Hart - Many, LA
Hartenbower Hectares - Lostant, IL
Hartford Municipal - Hartford, WI
Hartington Municipal - Hartington, NE
Hartsfield-Jackson Atlanta International Airport - Atlanta, GA
Hartsville Municipal Airport - Hartsville, SC
Hartwood - Sommerville, VA
Harvard State - Harvard, NE
Harvey - Snohomish, WA
Harvey Municipal - Harvey, ND
Harvey Young Airport - Tulsa, OK
Haskell - Haskell, OK
Haskell Municipal - Haskell, TX
Hassell - Clifton, TN
Hastings - Hastings, MI
Hastings Airport - Hastings, NE
Hat Field - Nunica, MI
Hatbox Field - Muskogee, OK
Hatch Municipal - Hatch, NM
Hatteras Airport - Hatteras, NC
Hattiesburg-Laurel Regional Airport - Laurel, MS
Havana Regional - Havana, IL
Havasupai Airport - Havasupai, AZ
Havre City County Airport - Havre, MT
Hawarden Municipal - Hawarden, IA
Hawk Inlet Sea Plane Base - Hawk Inlet, AK
Hawkins - Delta, CO
Hawkins Co - Rogersville, TN
Hawkins Field - Jackson, MS
Hawkinsville-Pulaski Co - Hawkinsville, GA
Hawley Municipal - Hawley, MN
Hawthorne - Kountze/Silsbee, TX
Hawthorne Airport - Hawthorne, NV
Hawthorne Municipal Airport - Hawthorne, CA
Hawthorne-Feather - Hillsboro, NH
Haxtun Municipal - Haxtun, CO
Hay Springs Municipal - Hay Springs, NE
Haycock Airport - Haycock, AK
Hayesport - Collinsville, TX
Hayfork - Hayfork, CA
Haynesville - Haynesville, LA
Hays Municipal Airport - Hays, KS
Hayward Executive Airport - Hayward, CA
Hayward Municipal Airport - Hayward, WI
Hazel Green - Hazel Green, AL
Hazelton Municipal - Hazelton, ID
Hazelton Municipal - Hazelton, ND
Hazen Municipal - Hazen, AR
Hazlehurst - Hazlehurst, GA
Hazleton Airport - Hazleton, PA
Headland Municipal - Headland, AL
Healdsburg Municipal - Healdsburg, CA
Healdton Municipal - Healdton, OK
Healy Lake Airport - Healy Lake, AK
Healy River - Healy, AK
Hearne Municipal - Hearne, TX
Heart Airport - Kansas City, MO
Heart Of Georgia Regional - Eastman, GA
Hebbelman - Chinook, MT
Heber City Mun-Mcdonald - Heber, UT
Heber Springs Municipal - Heber Springs, AR
Hebron Municipal - Hebron, ND
Hebron Municipal - Hebron, NE
Hector International Airport - Fargo, ND
Hector Municipal - Hector, MN
Helena Airport - Helena, MT
Helgeson - Two Harbors, MN
Helms Sevier Co - De Queen, AR
Hemingway Stuckey - Hemingway, SC
Hemphill Co - Canadian, TX
Henderson - Wallace, NC
Henderson Aviation - Felton, DE
Henderson City-Co - Henderson, KY
Henderson Executive Airport - Las Vegas, NV
Henderson Oxford Airport - Oxford, NC
Hendersonville - Hendersonville, NC
Hendricks - Gouverneur, NY
Henning Municipal - Henning, MN
Henry Co - Napoleon, OH
Henry County Airport - Paris, TN
Henry County Airport - Tara Field - Hampton, GA
Henry Tift Myers Airport - Tifton, GA
Henry'S Lake - Lake, ID
Henryetta Municipal - Henryetta, OK
Hensley Memorial - Fulton, MO
Hereford Municipal - Hereford, TX
Herendeen Airport - Herendeen, AK
Herington Regional - Herington, KS
Herlong - Herlong, CA
Herlong Recreational Airport - Jacksonville, FL
Herman Municipal - Herman, MN
Hermann Municipal - Hermann, MO
Hernando County Airport - Brooksville, FL
Hernando Village Airpark Inc - Hernando, MS
Herreid Municipal - Herreid, SD
Herron - New Cumberland, WV
Hesler-Noble Field - Laurel, MS
Hesperia - Hesperia, CA
Hester Memorial - Calhoun Falls, SC
Hettinger Municipal - Hettinger, ND
Hi Desert - Joshua Tree, CA
Hiatt - Thomasville, NC
Hickam Air Force Base - Honolulu, HI
Hickory Airport - Hickory, NC
Hicks - Ft Worth, TX
Hidden Falls Airport - Hidden Falls, AK
Hidden Hills - Pahrump, NV
Hidden Lake Airport - New Port Richey, FL
Higgins-Lipscomb Co - Higgins, TX
Higginsville Industrial Municipal Airport - Higginsville, MO
Highland Co - Hillsboro, OH
Highland-Winet Airport - Highland, IL
Highmore Municipal - Highmore, SD
Hill Air Force Base - Ogden, UT
Hill City Airport - Hill City, KS
Hill City-Quadna Mtn - Hill City, MN
Hillcrest - Goldendale, WA
Hillenbrand Airport - Batesville, IN
Hilliard - Hilliard, FL
Hillman - Hillman, MI
Hillsboro Municipal - Hillsboro, IL
Hillsboro Municipal - Hillsboro, ND
Hillsboro Municipal - Hillsboro, TX
Hillsdale Municipal - Hillsdale, MI
Hillside - Stilwell, KS
Hilo International Airport - Hilo, HI
Hilton Head Airport - Hilton Head, SC
Hiltons Har H Airport - Boulder, CO
Hinckley - Hinckley, IL
Hinde Airport - Huron, OH
Hinkles Ferry - Brazoria, TX
Hinsdale - Hinsdale, MT
Hinshaw - Liberty, NC
Hinton Municipal - Hinton, OK
Hinton-Alderson - Pence Springs, WV
Hoard Memorial - Leoti, KS
Hobart Airport - Hobart, OK
Hobart Bay Airport - Hobart Bay, AK
Hobart-Sky Ranch - Hobart, IN
Hobby - Creswell, OR
Hoby Wolf Airport - Eldersburg, MD
Hogatza Airport - Hogatza, AK
Hogeland - Hogeland, MT
Hogg Co - Hebbronville, TX
Holbrook Municipal - Holbrook, AZ
Holdenville Municipal - Holdenville, OK
Holikachu Airport - Holikachu, AK
Hollandale Municipal - Hollandale, MS
Hollands International - Newfane, NY
Holley Mountain - Clinton, AR
Hollis Municipal - Hollis, OK
Hollis Sea Plane Base - Hollis, AK
Hollister - Wilmington, OH
Hollister Airport - Hollister, CA
Hollister Municipal - Hollister, CA
Holloman Air Force Base - Alamogordo, NM
Hollow Regional - Albany, KY
Hollow Top - Martin, ID
Holly Grove Municipal - Holly Grove, AR
Holly Hill - Holly Hill, SC
Holly Ridge/Topsail I - Holly Ridge, NC
Holmes Co - Millersburg, OH
Holtville Airport - Holtville, CA
Holy Cross Airport - Holy Cross, AK
Holyoke Municipal - Holyoke, CO
Home Acres Sky Ranch - Lake City, MI
Homedale Municipal - Homedale, ID
Homer Airport - Homer, AK
Homer Municipal - Homer, LA
Homerville - Homerville, GA
Homeshore Airport - Homeshore, AK
Homestead Air Force Base - Homestead, FL
Homestead Farms - Pond Creek, OK
Homestead Gen Aviation - Homestead, FL
Hominy Municipal - Hominy, OK
Honeoye Falls - Honeoye Falls, NY
Honolulu International Airport - Honolulu, HI
Hood River - Hood River, OR
Hook Field - Middletown, OH
Hooker Municipal - Hooker, OK
Hooks Memorial - Rayville, LA
Hoonah Airport - Hoonah, AK
Hoopa - Hoopa, CA
Hooper Bay Airport - Hooper Bay, AK
Hope - Hope, AK
Hope Municipal - Hope, AR
Hopedale Industrial Park - Hopedale, MA
Hopewell - Canandaigua, NY
Hopkins - Nucla, CO
Hopkins-Fordyce Municipal - Fordyce, AR
Hopkinsville-Christian Co - Hopkinsville, KY
Horace Williams Airport - Chapel Hill, NC
Horizon - San Antonio, TX
Horlick Airport - Racine, WI
Hornell Municipal - Hornell, NY
Hornersville Memorial - Hornersville, MO
Horseshoe Bay - Marble Falls, TX
Horseshoe Bend - Horseshoe Bend, AR
Horseshoe Bend - Weatherford, TX
Hoskins - Olympia, WA
Hot Springs - Hot Springs, MT
Hot Springs Airport - Thermopolis, WY
Hot Springs Municipal - Hot Springs, SD
Hot Springs Sea Plane Base - Bell Island, AK
Houghton County Airport - Hancock, MI
Houghton Lake Heights - Houghton Heights, MI
Houlton International Airport - Houlton, ME
Houston Co - Caledonia, MN
Houston Co - Crockett, TX
Houston Co - Mc Kinnon, TN
Houston Memorial - Houston, MO
Houston Municipal - Houston, MS
Houston Southwest Airport - Houston, TX
Hoven Municipal - Hoven, SD
Howard Co - Nashville, AR
Howard County Airport - Big Spring, TX
Howard Municipal - Howard, SD
Howe - Howe, ID
Howell-New Lenox - New Lenox, IL
Howes Airport - Huron, SD
Hoxie-Sheridan Co - Hoxie, KS
Huggins Memorial - Timmonsville, SC
Hughes Airport - Culver City, CA
Hughes Municipal Airport - Hughes, AK
Hugo Airport - Hugo, OK
Hugoton Municipal - Hugoton, KS
Hulman Field - Terre Haute, IN
Humboldt Airport - Humboldt, IA
Humboldt Municipal - Humboldt, TN
Humboldt Municipal Airport - Humboldt, NE
Hummel - Saluda, VA
Humphreys Co - Waverly, TN
Hunt - Portland, TX
Hunt Field - Lander, WY
Hunter Air Force Base - Savannah, GA
Hunter Army Air Field - Jolon, CA
Huntingburg Municipal Airport - Huntingburg, IN
Huntington County Airport - Chesapeake, OH
Huntington Municipal - Huntington, IN
Huntington Municipal - Huntington, UT
Huntsville Airport - Huntsville, TX
Huntsville International Airport - Huntsville, AL
Huntsville-Madison Co Regional - Huntsville, AR
Hurdle - Mebane, NC
Hurlburt - Mary Esther, FL
Huron Co Memorial - Bad Axe, MI
Hurricane - Hurricane, UT
Huslia Airport - Huslia, AK
Hutchinson Airport - Hutchinson, KS
Hutchinson Mun-Butler - Hutchinson, MN
Hyampom - Hyampom, CA
Hyatt Regency Heliport - Cambridge, MA
Hyatt Regency Heliport - Dearborn, MI
Hydaburg Sea Plane Base - Hydaburg, AK
Hyde Co - Engelhard, NC
Hyder Sea Plane Base - Hyder, AK
Hysham - Hysham, MT
Icy Bay Airport - Icy Bay, AK
Ida Grove Municipal Airport - Ida Grove, IA
Idabel - Idabel, OK
Idaho City Usfs - Idaho City, ID
Idaho Co - Grangeville, ID
Igiugig Airport - Igiugig, AK
Igor I. Sikorsky Memorial Airport - Bridgeport, CT
Iliamna Airport - Iliamna, AK
Illinois Valley - Cave Junction, OR
Illinois Valley Regional Airport - Peru, IL
Immokalee Airport - Immokalee, FL
Imperial Airport - Imperial, NE
Imperial County Airport - Imperial, CA
Independence - Independence, CA
Independence Airport - Independence, KS
Independence Memorial Airport - Independence, MO
Independence Municipal - Independence, IA
Independence State - Independence, OR
Indian Creek Ranch - Deckerville, MI
Indian Creek Usfs - Indian Creek, ID
Indian Mountain Air Force Station - Utopia Creek, AK
Indiana Airport - Indiana, PA
Indianapolis Brookside Airport - Indianapolis, IN
Indianapolis Executive Airport - Indianapolis, IN
Indianapolis International Airport - Indianapolis, IN
Indianapolis Metropolitan Airport - Indianapolis, IN
Indianola Municipal - Indianola, MS
Indiantown - Indiantown, FL
Industrial - Courtland, AL
Industrial Airpark - Hobbs, NM
Industrial Airport - Ottumwa, IA
Industrial Airport - Roswell, NM
Industrial Airport - Tacoma, WA
Ingalls Field - Hot Springs, VA
Ingalls Municipal - Ingalls, KS
Ingersoll - Canton, IL
Inter Co - Irwin, PA
Intercontinental Airport - Louisville, KY
International Peace Garden - Dunseith, ND
Inverness - Inverness, FL
Ione Municipal - Ione, WA
Ionia Co - Ionia, MI
Iosco County Airport - East Tawas, MI
Iowa City Airport - Iowa City, IA
Iowa County Airport - Mineral Point, WI
Iowa Falls Airport - Iowa Falls, IA
Iraan Municipal Airport - Iraan, TX
Iron Co - Crystal Falls, MI
Ironhead - Sanger, TX
Isabel Municipal - Isabel, SD
Isabel Pass Airport - Isabel Pass, AK
Isbell - Ft Payne, AL
Island Heliport - Garden City, NY
Islesboro - Islesboro, ME
Iuka - Iuka, MS
Ivanof Bay Sea Plane Base - Ivanof Bay, AK
Iverson - Mc Gregor, MN
Ivishak Airport - Ivishak, AK
J-Z - Almira, WA
J. T. Robidoux Airport - Valle, AZ
Jaars-Townsend - Waxhaw, NC
Jablonski Airport - Nunica, MI
Jack Edwards Airport - Gulf Shores, AL
Jackass - Amargosa Valley, NV
Jackpot Airport - Jackpot, NV
Jacksboro Municipal - Jacksboro, TX
Jackson - Jackson, LA
Jackson Airport - Jackson, MN
Jackson Co - Edna, TX
Jackson Co - Gainesboro, TN
Jackson Co - Jefferson, GA
Jackson Co - Ravenswood, WV
Jackson Co - Sylva, NC
Jackson County Airport - Pascagoula, MS
Jackson Hole Airport - Jackson, WY
Jackson International Airport - Jackson, MS
Jackson Municipal - Jackson, AL
Jacksonville Airport - Jacksonville, TX
Jacksonville Executive at Craig Airport - Jacksonville, FL
Jacksonville International Airport - Jacksonville, FL
Jacksonville Municipal Airport - Jacksonville, IL
Jacksonville Naval Air Station - Jacksonville, FL
Jacqueline Cochran Regional Airport - Thermal, CA
Jacumba - Jacumba, CA
Jaffrey Municipal Airport - Jaffrey, NH
Jakes Bar - Mc Carthy, AK
Jakolof Bay - Jakolof Bay, AK
James M. Cox Dayton International Airport - Dayton, OH
Jamestown Airport - Jamestown, ND
Jamestown Airport - Jamestown, NY
Jamestown Municipal - Jamestown, TN
Jana - Edgerton, WI
Jean - Jean, NV
Jefferson City Memorial Airport - Jefferson City, MO
Jefferson Co - Steubenville, OH
Jefferson County Airport - Beaumont, TX
Jefferson County Airport - Dubois, PA
Jefferson Municipal Airport - Jefferson, IA
Jefferson Proving Ground - Madison, IN
Jekyll Island - Jekyll Island, GA
Jena - Jena, LA
Jenkins - Wyoming, DE
Jennings - Jennings, LA
Jerome Co - Jerome, ID
Jerry Tyler Memorial Airport - Niles, MI
Jersey Shore - Jersey Shore, PA
Jesup-Wayne County Airport - Jesup, GA
Jewett Mesa - Apache Creek, NM
Jicarilla Apache Nation - Dulce, NM
John C. Tune Airport - Nashville, TN
John Day Airport - John Day, OR
John F. Kennedy International Airport - New York, NY
John Wayne Airport - Santa Ana, CA
Johnson - Archdale, NC
Johnson - Port Mansfield, TX
Johnson Airport - Johnson, TX
Johnson City Stolport Airport - Johnson City, TN
Johnson Co - Mountain City, TN
Johnson Creek - Yellow Pine, ID
Johnson Executive Airport - Kansas City, MO
Johnson Field - Smiths Creek, MI
Johnson Industrial Airport - Kansas City, MO
Johnson Memorial - New Martinsville, WV
Johnson-Bell Field - Missoula, MT
Johnston County Airport - Smithfield, NC
Joliet Municipal Airport - Joliet, IL
Jones - Benkelman, NE
Jones - Bonham, TX
Jones - Linden, AL
Jones Lebanon - Lebanon, MO
Jones Memorial - Bristow, OK
Jonesboro Airport - Jonesboro, AR
Jonesboro Municipal - Jonesboro, LA
Jonesville - Jonesville, LA
Joplin Airport - Joplin, MO
Jordan Airport - Jordan, MT
Joseph State - Joseph, OR
Joyce - Winnfield, LA
Judge Lewis-Mt Ayr Municipal - Mt Ayr, IA
Julesburg Municipal - Julesburg, CO
Junction - Junction, UT
Juneau International Airport - Juneau, AK
Kadoka Municipal - Kadoka, SD
Kagvik Creek Airport - Kagvik Creek, AK
Kahoka Municipal - Kahoka, MO
Kahului Airport - Kahului, HI
Kake Sea Plane Base - Kake, AK
Kakhonak Airport - Kakhonak, AK
Kalaeloa Airport - Kapolei, HI
Kalakaket Air Force Station - Kalakaket, AK
Kalaupapa Airport - Kalaupapa, HI
Kalaupapa Apt. - Molokai  Hawaii, HI
Kalispell City - Kalispell, MT
Kalkaska City - Kalkaska, MI
Kalskag Municipal Airport - Kalskag, AK
Kaltag Airport - Kaltag, AK
Kamiah Municipal - Kamiah, ID
Kamp - Durhamville, NY
Kampel - Wellsville, PA
Kamuela Airport - Kamuela, HI
Kanab Airport - Kanab, UT
Kaneohe Bay Mcaf - Mokapu, HI
Kankakee - Kankakee, IL
Kansas City Downtown Municipal Airport - Kansas City, MO
Kansas City International Airport - Kansas City, MO
Kantishna - Kantishna, AK
Kaolin - Sandersville, GA
Kapalua Airport - Kapalua, HI
Kapaun-Wilson - Graceville, MN
Karlstad Municipal - Karlstad, MN
Karluk Airport - Karluk, AK
Karluk Lake Sea Plane Base - Karluk Lake, AK
Karnes Co - Kenedy, TX
Kasaan Sea Plane Base - Kasaan, AK
Kasigluk Airport - Kasigluk, AK
Kasilof - Kasilof, AK
Katama - Edgartown, MA
Kearney Airport - Kearney, NE
Kearny - Kearny, AZ
Keck'S - Julian, NC
Kee - Pineville, WV
Keesler Air Force Base - Biloxi, MS
Kegelman Air Field - Cherokee, OK
Kellam - Weirwood, VA
Keller Brothers Airport - Lebanon, PA
Kelleys Island Land Field - Kelleys Island, OH
Kelly - Oak Grove, LA
Kelly Bar Airport - Kelly Bar, AK
Kelly Field Annex - San Antonio, TX
Kelp Bay Airport - Kelp Bay, AK
Kemmerer Airport - Kemmerer, WY
Kenai Airport - Kenai, AK
Kendallville Municipal - Kendallville, IN
Kenmare Municipal - Kenmare, ND
Kenmore Air Harbor Airport - Kenmore Air Harbor, WA
Kennett Municipal Airport - Kennett, MO
Kenosha Municipal Airport - Kenosha, WI
Kent Co - Jayton, TX
Kent State University Airport - Kent, OH
Kentland Airport - Kentland, IN
Kentmorr - Stevensville, MD
Kentucky Dam State Park - Gilbertsville, KY
Keokuk Airport - Keokuk, IA
Keosauqua Municipal - Keosauqua, IA
Kern County Airport - Inyokern, CA
Kern County Airport - Mojave, CA
Kern County Airport - Shafter, CA
Kern County Airport - Tehachapi, CA
Kern Valley - Kernville, CA
Kerrville Airport - Kerrville, TX
Kestrel - San Antonio, TX
Ketchikan International Airport - Ketchikan, AK
Kewanee Municipal - Kewanee, IL
Key Field - Meridian, MS
Key West International Airport - Key West, FL
Keystone - Keystone Heights, FL
Keystone - Unionville, PA
Keystone - Westport, OK
Kibs - Bristol, LA
Kickapoo Airport - Wichita Falls, TX
Kidwell - Cal Nev Ari, NV
Killeen Municipal Airport - Killeen, TX
Kimball Municipal - Kimball, SD
Kimball Municipal/Arraj - Kimball, NE
Kimble County Airport - Junction, TX
Kincheloe Air Force Base - Sault Ste. Marie, MI
King Cove Airport - King Cove, AK
King Of Prussia Airport - King of Prussia, PA
King Salmon Airport - King Salmon, AK
Kingdon - Lodi, CA
Kingfisher - Kingfisher, OK
Kingman Airport - Kingman, AZ
Kingman Municipal - Kingman, KS
Kings Land O'Lakes - Land O'Lakes, WI
Kingsley Field - Klamath Falls, OR
Kingston-Ulster - Kingston, NY
Kinsley Municipal - Kinsley, KS
Kipnuk Sea Plane Base - Kipnuk, AK
Kirbyville - Kirbyville, TX
Kirk Air Base - Lancaster, SC
Kirksville Municipal Airport - Kirksville, MO
Kirkwood - Kirkwood, NY
Kirsch Municipal - Sturgis, MI
Kissimmee Gateway Airport - Kissimmee, FL
Kit Carson Co - Burlington, CO
Kittie Hill - Leander, TX
Kittyhawk - Allen, TX
Kitui Bay Sea Plane Base - Kitui Bay, AK
Kivalina Airport - Kivalina, AK
Kizer - Prescott, AR
Kizhuyak Airport - Kizhuyak, AK
Klagbay Airport - Klagbay, AK
Klawock Airport - Klawock, AK
Kleberg Co - Kingsville, TX
Kline Kill - Ghent, NY
Kneeland - Eureka, CA
Knox Airport - Quaker Street, NY
Knox Co - Mt Vernon, OH
Knox County Regional Airport - Rockland, ME
Knoxville Municipal - Knoxville, IA
Knoxville-Downtown I - Knoxville, TN
Kobelt - Wallkill, NY
Kobuk/Wien Airport - Kobuk, AK
Koch - Poseyville, IN
Kodiak Airport - Kodiak, AK
Kodiak FSS Airport - Kodiak, AK
Kodiak Municipal Airport - Kodiak, AK
Kokhanok - Kokhanok, AK
Kokomo Airport - Kokomo, IN
Koliganek - Koliganek, AK
Kona International Airport at Keahole - Kailua-Kona, HI
Kongiganak Airport - Kongiganak, AK
Koons - Salem, OH
Kooskia Municipal - Kooskia, ID
Kotlik Airport - Kotlik, AK
Kotlik/New - Kotlik, AK
Kotzebue Airport - Kotzebue, AK
Koyuk Airport - Koyuk, AK
Koyukuk Airport - Koyukuk, AK
Krassel Usfs - Mc Call, ID
Kroelinger - Vineland, NJ
Kugururok River Airport - Kugururok River, AK
Kulik Lake Airport - Kulik Lake, AK
Kuparuk Airport - Kuparuk, AK
Kupper Airport - Manville, NJ
Kure - Kure I, HI
Kutztown - Kutztown, PA
Kwethluk Airport - Kwethluk, AK
Kwigillingok Airport - Kwigillingok, AK
Kwinhagak Airport - Quinhagak, AK
La Belle Municipal - La Belle, FL
La Crosse Regional Airport - La Crosse, WI
La Grande Airport - La Grande, OR
La Junta Municipal - La Junta, CO
La Moure Rott Municipal - La Moure, ND
La Plata Airport - Durango, CO
La Porte Municipal Airport - La Porte, TX
LA/Ontario International Airport - Ontario, CA
Labouchere Bay Airport - Labouchere Bay, AK
Lackey Aviation - Wharton, TX
Laconia Municipal Airport - Laconia, NH
Lafayette Municipal - Lafayette, TN
Lafayette Regional Airport - Lafayette, LA
Lago Vista-Allen - Lago Vista, TX
LaGuardia Airport - New York, NY
Laguna Army Air Field - Yuma, AZ
Lahm Municipal Airport - Mansfield, OH
Laidlaw Corrals - Kimama, ID
Lake Andes Municipal - Lake Andes, SD
Lake Anna - Bumpass, VA
Lake Barkley State Park - Cadiz, KY
Lake Billy Chinook State - Culver, OR
Lake Charles Municipal Airport - Lake Charles, LA
Lake City Gateway Airport - Lake City, FL
Lake City Mun Evans - Lake City, SC
Lake County Airport - Lakeview, OR
Lake County Regional Airport - Clarksville, VA
Lake Elmo - St Paul, MN
Lake Geneva Municipal Airport - Lake Geneva, WI
Lake Havasu City Municipal Airport - Lake Havasu City, AZ
Lake Hood Seaplane Base  - Anchorage, AK
Lake Hood Strip - Anchorage, AK
Lake In The Hills - Lake In The Hills, IL
Lake Isabella - Village Of Lake Isabella, MI
Lake Lawn - Delavan, WI
Lake Louise - Lake Louise, AK
Lake Mills Municipal - Lake Mills, IA
Lake Minchumina Airport - Lake Minchumina, AK
Lake Murray State Park - Overbrook, OK
Lake Norman Airport - Mooresville, NC
Lake Placid Airport - Lake Placid, NY
Lake Preston Municipal - Lake Preston, SD
Lake Texoma State Park - Kingston, OK
Lake Union Sea Plane Base - Seattle, WA
Lake Village - Lake Village, IN
Lake Village Municipal - Lake Village, AR
Lake Wales Municipal - Lake Wales, FL
Lake Wenatchee State - Leavenworth, WA
Lake Whitney State Park - Whitney, TX
Lakefield - Celina, OH
Lakefront Airport - New Orleans, LA
Lakehill - Mars, PA
Lakeland Municipal Airport - Lakeland, FL
Lakes Of The North - Gaylord, MI
Lakes Region - Wolfeboro, NH
Lakeside Airport - Lakeside, TX
Lakeside State - Lakeside, OR
Lakeside United States Air Force - Duluth, MN
Lakeview - Lake Dallas, TX
Lakeview-Griffith - Lakeview, MI
Lakeway - Austin, TX
Lakewood - Lakewood, NJ
Lakewood Country Club - Lakewood, WI
Lakin - Lakin, KS
Lakota Municipal - Lakota, ND
Lamar Co - Vernon, AL
Lamar Field - Lamar, CO
Lamar Municipal - Lamar, MO
Lambert Fechter Municipal - Hartley, IA
Lambert-St. Louis International Airport - Saint Louis, MO
Lamesa Municipal - Lamesa, TX
Lamoni Municipal - Lamoni, IA
Lampasas - Lampasas, TX
Lampson - Lakeport, CA
Lanai Airport - Lanai, HI
Lancaster - Lancaster, TX
Lancaster Airport - Lancaster, PA
Lancaster Co-Mc Whirter - Lancaster, SC
Lancaster Municipal - Lancaster, WI
Lander County Airport - Battle Mountain, NV
Landings Condominium - Huntley, IL
Landmark Usfs - Landmark, ID
Lane - Sanger, TX
Laneys - Maiden, NC
Langlade Co - Antigo, WI
Langley Air Force Base - Hampton, VA
Lansdowne Airport - Youngstown, OH
Lansing Municipal - Chicago, IL
Laporte Municipal Airport - Laporte, IN
Laredo International Airport - Laredo, TX
Larimore Municipal - Larimore, ND
Larkin - Palatka, FL
Larned-Pawnee Co - Larned, KS
Larsen - Belleville, MI
Larsen Sea Plane Base - Larsen Bay, AK
Larsh - Colfax, IN
Larson Air Force Base - Moses Lake, WA
Las Animas Airport - Trinidad, CO
Las Cruces Municipal Airport - Las Cruces, NM
Las Vegas Airport - Las Vegas, NM
Lathrop Wells Airport - Lathrop Wells, NV
Laughlin Afb Aux No 1 - Spofford, TX
Laughlin Air Force Base - Del Rio, TX
Laughlin Bullhead International Airport - Bullhead City, AZ
Laurel - Laurel, DE
Laurel Municipal - Laurel, MT
Laurens Co - Laurens, SC
Laverne Municipal - Laverne, OK
Lavina - Lavina, MT
Lawing - Lawing, AK
Lawrence Airport - Lawrence, KS
Lawrence Airport - Lawrence, MA
Lawrence J. Timmerman Airport - Milwaukee, WI
Lawrenceburg-Lawrence Co - Lawrenceburg, TN
Lawrenceville Airport - Lawrenceville, VA
Lawrenceville Municipal Airport - Lawrenceville, IL
Lawson Army Air Field - Fort Benning, GA
Lawton-Fort Sill Regional Airport - Lawton, OK
Le Gros Memorial - Crowley, LA
Le Maire Memorial - Jeanerette, LA
Le Roy - Le Roy, NY
Le Sueur Municipal - Le Sueur, MN
Lea Co - Jal, NM
Lea Co - Tatum, NM
Lea Co-Franklin Memorial - Lovington, NM
Lea County Airport - Hobbs, NM
Leach - Center, CO
Leaders/Clear Lake Airport - Clear Lake, MN
Leadore - Leadore, ID
Leadville Airport - Leadville, CO
Lebanon Municipal Airport - Lebanon, TN
Lebanon Regional Airport - Lebanon, NH
Lebanon State - Lebanon, OR
Lebanon-Springfield Airport - Springfield, KY
Lebanon-Warren Co - Lebanon, OH
Leckrone Airport - Salem, IL
Ledgedale - Brockport, NY
Lee - De Land, FL
Lee Airport - Annapolis, MD
Lee Bird Field - North Platte, NE
Lee Bottom - Hanover, IN
Lee C Fine Memorial Airport - Kaiser/Lake Ozark, MO
Lee Co - Bishopville, SC
Lee Co - Pennington Gap, VA
Lee Co-Marianna - Marianna, AR
Lee Gilmer Memorial Airport - Gainesville, GA
Lee Vining - Lee Vining, CA
Lee's Summit Municipal Airport - Lee's Summit, MO
Leeds Municipal - Leeds, ND
Leesburg Airport - Leesburg, FL
Leesburg Executive - Leesburg, VA
Leesville - Leesville, LA
Leeward Farm - Soldiers Grove, WI
Leflore Airport - Greenwood, MS
Lehigh Valley International Airport - Allentown, PA
Leland - Leland, IL
Lemars Municipal Airport - Lemars, IA
Lemmon Airport - Lemmon, SD
Lemons Municipal Airport - Tupelo, MS
Lenawee County Airport - Adrian, MI
Lenhardt - Hubbard, OR
Lenoir Airport - Morganton, NC
Lenora Municipal - Lenora, KS
Leon - Leon, WV
Leonard Municipal - Leonard, ND
Levelland Municipal - Levelland, TX
Levelock Airport - Levelock, AK
Lewis Airport - Cedar Key, FL
Lewis Co Regional - Monticello, MO
Lewis Lockport Airport - Lockport, IL
Lewis Ranch - Leakey, TX
Lewistown Municipal Airport - Lewistown, MT
Lexington - Lexington, OR
Lexington Airport - Lexington, NE
Lexington Co - Gaston, SC
Lexington Municipal Airport - Lexington, MO
Li Calzi - Bridgeton, NJ
Libby - Libby, MT
Liberal Municipal Airport - Liberal, KS
Liberty Co - Chester, MT
Liberty Co - Hinesville, GA
Liberty Municipal Airport - Liberty, TX
Liberty-Casey Co - Liberty, KY
Lida Junction - Goldfield, NV
Lidgerwood Municipal - Lidgerwood, ND
Lignite - Lignite, AK
Lihue Airport - Kauai Island, HI
Lime Village Airport - Lime Village, AK
Limington-Harmon - Limington, ME
Limon Municipal Airport - Limon, CO
Lincoln - Lincoln, MT
Lincoln Co - Panaca, NV
Lincoln Municipal - Lincoln, MO
Lincoln Municipal Airport - Lincoln, NE
Lincoln Park - Lincoln Park, NJ
Lincoln Regional - Lincoln, ME
Lincoln Regional/Harder - Lincoln, CA
Lincolnton-Lincoln Co - Lincolnton, NC
Lind - Lind, WA
Lindberg - Hessel, MI
Linden Airport - Linden, NJ
Lindrith - Lindrith, NM
Lindsay Municipal - Lindsay, OK
Linn State Tech College - Linn, MO
Linton Municipal - Linton, ND
Lisbon Municipal - Lisbon, ND
Litchfield Municipal - Litchfield, IL
Litchfield Municipal - Litchfield, MN
Little Falls-Morrison Co - Little Falls, MN
Little Goose Lock & Dam - Starbuck, WA
Little Naukati Airport - Little Naukati, AK
Little Port Walter Airport - Little Port Walter, AK
Little River - Little River, CA
Little Rock Air Force Base - Jacksonville, AR
Littlebrook - Eliot, ME
Littlefield Municipal - Littlefield, TX
Littlefork Municipal/Hanover - Littlefork, MN
Live Oak Co - George West, TX
Livengood Airport - Livengood, AK
Livermore Airport - Livermore, CA
Livingston Co - Howell, MI
Livingston Municipal - Livingston, TN
Livingston Municipal - Livingston, TX
Llano Municipal - Llano, TX
Loars Field Inc - Onsted, MI
Lochridge Ranch - Athens, TX
Lockhart Municipal - Lockhart, TX
Lodi - Lodi, CA
Logan Co - Lincoln, IL
Logan Co - Logan, WV
Logan International Airport - Boston, MA
Logansport Municipal - Logansport, IN
Lompoc Airport - Lompoc, CA
Lone Hickory - Yadkinville, NC
Lone Pine - Lone Pine, CA
Lone Star Steel Company - Lone Star, TX
Long Beach Airport - Long Beach, CA
Long Beach Heliport - Long Beach, CA
Long Island Airport - Long Island, AK
Long Island MacArthur Airport - Ronkonkoma, NY
Longview Airport - Kelso, WA
Longview Airport - Longview, WA
Longville Municipal - Longville, MN
Lopez Island Airport - Lopez Island, WA
Lorain County Regional Airport - Lorain/Elyria, OH
Lordsburg Airport - Lordsburg, NM
Loring Air Force Base - Limestone, ME
Loring Airport - Loring, AK
Los Alamitos Aaf - Los Alamitos, CA
Los Alamos Airport - Los Alamos, NM
Los Angeles International Airport - Los Angeles, CA
Los Banos Airport - Los Banos, CA
Lost Bridge Village - Garfield, AR
Lost Creek - Luzerne, MI
Lost Harbor Sea Port - Lost Harbor, AK
Lost Hills-Kern Co - Lost Hills, CA
Lost Nation Airport - Willoughby, OH
Lost River Airport - Lost River, AK
Lost River Resort - Mazama, WA
Lott International - Pascagoula, MS
Louis Armstrong New Orleans International Airport - New Orleans, LA
Louisa Airport - Louisa, VA
Louisiana Regional - Gonzales, LA
Louisville International Airport - Louisville, KY
Louisville Municipal - Louisville, GA
Loup City Municipal - Loup City, NE
Love Co - Marietta, OK
Lovell Field - Chattanooga, TN
Lowe Army Heliport - Ozark, AL
Lowell - Lowell, IN
Lowell City - Lowell, MI
Lower Granite State - Colfax, WA
Lower Monumental State - Kahlotus, WA
Lowndes County Airport - Columbus, MS
Lubbock International Airport - Lubbock, TX
Lubec Municipal - Lubec, ME
Lucas - Lucas, KS
Luce Co - Newberry, MI
Lufker - East Moriches, NY
Lufkin Angelina County Airport - Nacogdoches, TX
Luke Air Force Base - Phoenix, AZ
Lumberton Airport - Lumberton, NC
Lumpkin Co-Wimpy'S - Dahlonega, GA
Lunenburg Co - Kenbridge, VA
Luray Caverns - Luray, VA
Lusk Municipal - Lusk, WY
Luther - Chittenango, NY
Lycoming County Airport - Williamsport, PA
Lynden - Lynden, WA
Lyndonville Airport - Lyndonville, VT
Lyon - Thornwell, LA
Lyons - Rainsville, AL
M Graham Clark Airport - Branson/Point Lookout, MO
Maben - Lexington & Prattsville, NY
MacDill Air Force Base - Tampa, FL
Machesney Airport - Rockford, IL
Machias-Valley - Machias, ME
Mack Mesa - Mack, CO
Mackall Army Air Field - Hoffman, NC
Mackay - Mackay, ID
Mackinac Co - St Ignace, MI
Mackinac Island Airport - Mackinac Island, MI
Macomb - New Haven, MI
Macomb Municipal Airport - Macomb, IL
Macon Co - Franklin, NC
Macon Municipal - Macon, MS
Mad River - Tremont City, OH
Maddock Municipal - Maddock, ND
Madeline I - La Pointe, WI
Madera Airport - Madera, CA
Madill Municipal - Madill, OK
Madison Airport - Madison, CT
Madison Airport - Madison, SD
Madison Airport - Richmond, KY
Madison Co - London, OH
Madison Co Executive - Huntsville, AL
Madison Municipal - Madison, GA
Madison Municipal Airport - Madison, IN
Madison-Lac Qui Parle Co - Madison, MN
Madisonville Municipal - Madisonville, KY
Madisonville Municipal - Madisonville, TX
Madras City-County Airport - Madras, OR
Magdalena Municipal - Magdalena, NM
Magee - Coeur D'Alene, ID
Magee Municipal - Magee, MS
Magic Reservoir - Hailey, ID
Magnolia Municipal Airport - Magnolia, AR
Mahnomen Co - Mahnomen, MN
Mahoney Creek Usfs - Mahoney Creek, ID
Maidens - Williamston, MI
Maize - Wichita, KS
Majors Field - Greenville, TX
Malad City Airport - Malad City, ID
Malden Airport - Malden, MO
Maley - Shinnston, WV
Malin - Malin, OR
Mallard - York, AL
Malmstrom Air Force Base - Great Falls, MT
Malone-Dufort - Malone, NY
Malta - Malta, MT
Malta - Malta, MT
Malvern Municipal - Malvern, AR
Mammoth Lakes Airport - Mammoth Lakes, CA
Manassas Airport - Manassas, VA
Mancelona Municipal - Mancelona, MI
Manchester Boston Regional Airport - Manchester, NH
Manchester Municipal - Manchester, IA
Mandan Municipal - Mandan, ND
Manhattan Municipal Airport - Manhattan, KS
Manila - Manila, UT
Manila Municipal Airport - Manila, AR
Manito Mitchell - Manito, IL
Manitowish Waters - Manitowish Waters, WI
Manitowoc Municipal Airport - Manitowoc, WI
Mankato - Mankato, KS
Mankato Municipal Airport - Mankato, MN
Mankato Municipal Heliport - Mankato, MN
Manley Hot Springs Airport - Manley Hot Springs, AK
Manning - Jefferson, TX
Manokotak Sea Plane Base - Manokotak, AK
Mansfield - Mansfield, WA
Mansfield Municipal - Mansfield, MA
Mansfield Municipal - Mansfield, MO
Manti-Ephraim Airport - Manti, UT
Maple Grove - Fowlerville, MI
Maple Lake Municipal - Maple Lake, MN
Maples - Canyon, TX
Maquoketa Municipal - Maquoketa, IA
Marana Airport - Marana, AZ
Marathon Flight Strip - Marathon, FL
Marble Canyon Airport - Marble Canyon, AZ
Marceline Municipal - Marceline, MO
March Air Reserve Base - Riverside, CA
Marco Island Airport - Marco Island, FL
Marcy - Keene, NY
Marfa Municipal Airport - Marfa, TX
Marguerite Bay Airport - Marguerite Bay, AK
Marian - Wellington, TX
Marianna Municipal - Marianna, FL
Marin County Airport - Sausalito, CA
Marina - Marina, CA
Marine City - Marine City, MI
Marine Corps Air Station Cherry Point - Cherry Point, NC
Marine Corps Air Station Miramar - San Diego, CA
Marion - Marion, IA
Marion Airport - Marion, IN
Marion Co - Buena Vista, GA
Marion Co - Marion, SC
Marion County Airport - Hamilton, AL
Marion County Airport - Jasper, TN
Marion Municipal - Marion, KS
Marion Municipal Airport - Marion, OH
Marion-Crittenden Co - Marion, KY
Mariposa-Yosemite - Mariposa, CA
Marked Tree Municipal - Marked Tree, AR
Market Centre Heliport - Dallas, TX
Marksville Municipal - Marksville, LA
Marlboro - Matawan, NJ
Marlborough Airport - Marlborough, MA
Marlette - Marlette, MI
Marlin - Marlin, TX
Marriot Astrodome Heliport - Houston, TX
Marshall Airport - Marshall, AK
Marshall Army Air Field - Fort Riley, KS
Marshall Co - Holly Springs, MS
Marshall Co - Lacon, IL
Marshall Co - Moundsville, WV
Marshall Municipal Airport-Ryan Field - Marshall, MN
Marshalltown Municipal Airport - Marshalltown, IA
Marshfield - Marshfield, MA
Marshfield Municipal Airport - Marshfield, WI
Martha Lake - Alderwood Manor, WA
Martha's Vineyard Airport - Martha's Vineyard, MA
Martin - College Place, WA
Martin - South Sioux City, NE
Martin Co - Williamston, NC
Martin Johnson Airport - Chanute, KS
Martin Municipal - Martin, SD
Martindale Army Air Field - San Antonio, TX
Martinsburg Airport - Martinsburg, WV
Maryland - Indian Head, MD
Marysville Municipal - Marysville, KS
Maryville Memorial - Maryville, MO
Mason City Airport - Mason City, IA
Mason Co - Ludington, MI
Mason Co - Mason, TX
Mason Co - Point Pleasant, WV
Mason Jewett - Mason, MI
Massey Ranch - New Smyrna Beach, FL
Matagorda Air Force Base - Matagorda Island, TX
Mathews Memorial - Tipton, IA
Mathis - Cumming, GA
Mathis Field - San Angelo, TX
Mattituck - Mattituck, NY
Maury County Airport - Columbia, TN
Mauston-New Lisbon Union - New Lisbon, WI
Maverick County Airport - Eagle Pass, TX
Maverick County Memorial International Airport - Eagle Pass, TX
Max Westheimer Airport - Norman, OK
Maxson Airfield - Alexandria Bay, NY
Maxton Airport - Maxton, NC
Maxwell Air Force Base - Montgomery, AL
May - Houston, TX
May - May, ID
May Creek Airport - May Creek, AK
Mayes - Carson City, MI
Mayfield Airport - Akron, OH
Mayfield-Graves Co - Mayfield, KY
Mayport Naval Station - Mayport, FL
Mayville Municipal - Mayville, ND
Mc Alester Airport - Mc Alester, OK
Mc Beth - Klamath Glen, CA
Mc Call Airport - Mc Call, ID
Mc Campbell - Ingleside, TX
Mc Carley - Blackfoot, ID
Mc Carthy Airport - McCarthy, AK
Mc Caslin - Lexington, OK
Mc Charen - West Point, MS
Mc Clusky Municipal - Mc Clusky, ND
Mc Cook Airport - McCook, NE
Mc Cormick Co - Mc Cormick, SC
Mc Creary Co - Pine Knot, KY
Mc Crory-Morton - Mc Crory, AR
Mc Curtain Co Regional - Idabel, OK
Mc Dermitt State - Mc Dermitt, OR
Mc Donald - Taplin, WV
Mc Elroy - Kremmling, CO
Mc Gehee Catfish Restaurant - Marietta, OK
Mc Gehee Municipal - Mc Gehee, AR
Mc Ghee Tyson Airport - Knoxville, TN
Mc Ginness - Columbia, PA
Mc Gregor Executive - Waco, TX
Mc Intosh Municipal - Mc Intosh, SD
Mc Kenzie - Avinger, TX
Mc Kenzie Bridge State - Mc Kenzie Bridge, OR
Mc Kinley - Pearsall, TX
Mc Kinney Municipal - Mc Kinney, TX
Mc Laughlin Municipal - Mc Laughlin, SD
Mc Lean-Gray Co - Mc Lean, TX
Mc Minn - Weaver, AL
Mc Minnville Municipal - Mc Minnville, OR
Mc Namara Field - Crescent City, CA
Mc Neal'S - East Moline, IL
Mc Ville - Freeport, PA
Mc Ville Municipal - Mc Ville, ND
McCarran International Airport - Las Vegas, NV
McChord Air Force Base - Tacoma, WA
McClellan Air Force Base - Sacramento, CA
McClellan-Palomar Airport - Carlsbad, CA
McConnell Air Force Base - Wichita, KS
McEntire Joint National Guard Base - Columbia, SC
McGrath Airport - McGrath, AK
McGuire Air Force Base - Trenton, NJ
Mckellar Airport - Jackson, TN
McKenna Army Air Field - Columbus, GA
Mckeon Aviation - Denison, TX
McKinnon Airport - Brunswick, GA
McMinn County Airport - Athens, TN
McNary Field - Salem, OR
McPherson Airport - McPherson, KS
Mead Flying Service - Mead, WA
Meade Municipal - Meade, KS
Meadow Brook - Walnut Cove, NC
Meadow Creek Usfs - Meadow Creek, MT
Meadow Lake - Colorado Springs, CO
Meadow Lake - Kingston, TN
Meadows Field - Bakersfield, CA
Meadville Airport - Meadville, PA
Mecklenburg-Brunswick Regional - South Hill, VA
Mecosta Morton - Mecosta, MI
Medford Airport - Medford, WI
Medford Municipal - Medford, OK
Medfra Airport - Medfra, AK
Medicine Bow - Medicine Bow, WY
Medina Municipal Airport - Medina, OH
Meeker - Meeker, CO
Melbourne International Airport - Melbourne, FL
Melbourne Mun - Miller - Melbourne, AR
Melon - Rocky Ford, CO
Melsing Creek Airport - Council, AK
Memaloose - Imnaha, OR
Memorial Field - Hot Springs, AR
Memorial Municipal Airport - Marshall, MO
Memphis International Airport - Memphis, TN
Memphis Memorial - Memphis, MO
Memphis Municipal - Memphis, TX
Mena Intermountain Municipal - Mena, AR
Menard Co - Menard, TX
Mendota - Mendota, CA
Menominee Airport - Menominee, MI
Menomonie Mun-Score - Menomonie, WI
Mentone - Mentone, IN
Merced Municipal Airport - Merced, CA
Mercer Co - Aledo, IL
Mercer Co Regional - Hazen, ND
Mercer County Airport - Bluefield, WV
Meriden Markham Municipal - Meriden, CT
Meridian Nas - Meridian, MS
Merillat - Tecumseh, MI
Merkel Sylacauga Municipal - Sylacauga, AL
Merrill C Meigs Field - Chicago, IL
Merrill Field - Anchorage, AK
Merrill Municipal Airport - Merrill, WI
Merritt Island Airport - Cocoa, FL
Merrymeeting - Bowdoinham, ME
Mesa Del Rey Airport - King City, CA
Mesquite - Mesquite, NV
Mesquite Airport - Mesquite, NV
Mesquite Metro - Mesquite, TX
Methow Valley State - Winthrop, WA
Metlakatla Sea Plane Base - Metlakatla, AK
Metro Field - Fairbanks, AK
Metropolis Municipal - Metropolis, IL
Metropolitan Area Airport - Oakland, MD
Metropolitan Oakland International Airport - Oakland, CA
Metroport Airport - Clear Lake City, TX
Metter Municipal - Metter, GA
Mettle Field - Connersville, IN
Mexia-Limestone Co - Mexia, TX
Mexico Farms - Cumberland, MD
Mexico Memorial - Mexico, MO
Meyers Chuck Sea Plane Base - Meyers Chuck, AK
Meyers-Diver'S - Tecumseh, MI
Miami Airport - Miami, OK
Miami Downtown Heliport - Miami, FL
Miami International Airport - Miami, FL
Miami Sea Plane Base - Miami, FL
Miami University Airport - Oxford, OH
Miami-Roberts Co - Miami, TX
Michael - Cicero, NY
Michael Army Air Field - Dugway, UT
Michigan City Airport - Michigan City, IN
Micro - Stuart, VA
Mid Continent - Hayti, MO
Mid Florida Air Svc - Eustis, FL
Mid Valley - Los Lunas, NM
Mid Valley - Weslaco, TX
Mid-America Industrial - Pryor, OK
Mid-Atlantic Soaring Center - Fairfield, PA
Mid-Continent Airport - Wichita, KS
Mid-State Airport - Philipsburg, PA
Mid-Way - Midlothian/Waxahachie, TX
Middle Bass-East Point Airport - Middle Bass I, OH
Middle Georgia Regional Airport - Macon, GA
Middle Peninsula Regional - West Point, VA
Middlebury State - Middlebury, VT
Middlesboro-Bell Co - Middlesboro, KY
Middlesex Valley - Middlesex, NY
Middleton - Evergreen, AL
Middleton Island Intermediate Airport - Middleton Island, AK
Middleton Municipal Airport - Middleton, WI
Midlakes - Gorham, NY
Midland Airpark - Midland, TX
Midland International Airport - Midland/Odessa, TX
Midway - Albion, MI
Midway - Atomic City, ID
Midwest National Air Center Airport - Mosby, MO
Mifflin County Airport - Reedsville, PA
Mifflintown - Mifflintown, PA
Mignon Laird Municipal - Cheyenne, OK
Mikeska - Brookshire, TX
Milaca Municipal - Milaca, MN
Milan Airport - Grants, NM
Milbank Municipal - Milbank, SD
Miles City Municipal Airport - Miles City, MT
Milford Airport - Milford, UT
Millard - Annville, PA
Millard Airport - Omaha, NE
Millen - Millen, GA
Miller - Alliance, OH
Miller - Bluffton, IN
Miller - Burgettstown, PA
Miller - Dalhart, TX
Miller Aaf - Camp Ripley, MN
Miller Farm - Baltimore, OH
Miller Field - Reed City, MI
Miller Field - Valentine, NE
Miller International Airport - McAllen, TX
Miller Memorial - Vale, OR
Miller Municipal - Miller, SD
Millinocket Airport - Millinocket, ME
Mills - Mantua, OH
Millville Airport - Millville, NJ
Milnor Municipal - Milnor, ND
Mina - Mina, NV
Minchumina Intermediate Airport - Minchumina, AK
Minden-Webster - Minden, LA
Mineola Wisener - Mineola, TX
Mineral Co - Superior, MT
Mineral Co Memorial - Creede, CO
Mineral Wells Airport - Mineral Wells, TX
Mingo Co - Williamson, WV
Minneapolis City Co - Minneapolis, KS
Minneapolis Downtown Heliport - Minneapolis, MN
Minneapolis-St. Paul International Airport - Minneapolis, MN
Minot Air Force Base - Minot, ND
Minot International Airport - Minot, ND
Minto Airport - Minto, AK
Minto Municipal - Minto, ND
Minute Man Airfield - Stow, MA
Mishawaka Pilots Club - Elkhart, IN
Mission Field - Livingston, MT
Mission Sioux - Mission, SD
Mississippi Co - Charleston, MO
Mitchell Municipal Airport - Mitchell, SD
Moberly Airport - Moberly, MO
Mobile Downtown Airport - Mobile, AL
Mobile Regional Airport - Mobile, AL
Mobridge Municipal Airport - Mobridge, SD
Modesto Municipal Airport - Modesto, CA
Modisett - Rushville, NE
Moffett Federal Afld - Mountain View, CA
Moffett Federal Field - Mountain View, CA
Mohall Municipal - Mohall, ND
Molokai Airport - Hoolehua, HI
Mondell Airport - Newcastle, WY
Monett Municipal - Monett, MO
Monmouth Executive Airport - Belmar, NJ
Monmouth Municipal - Monmouth, IL
Monona Municipal - Monona, IA
Monroe - Monroe, NC
Monroe Co - Aberdeen-Amory, MS
Monroe Co - Madisonville, TN
Monroe Co - Woodsfield, OH
Monroe County Airport - Monroeville, AL
Monroe Municipal - Monroe, WI
Monroe Regional Airport - Monroe, LA
Monroe-Walton Co - Monroe, GA
Montague-Yreka Rohrer - Montague, CA
Monte Vista Municipal - Monte Vista, CO
Monterey Peninsula Airport - Monterey, CA
Montevideo Municipal Airport - Montevideo, MN
Montezuma County Airport - Cortez, CO
Montgomery - Forest, MS
Montgomery Co - Star, NC
Montgomery County Airport - Conroe, TX
Montgomery County Airport - Dayton, OH
Montgomery County Airport - Gaithersburg, MD
Montgomery Field - San Diego, CA
Montgomery-Wehrman - Montgomery City, MO
Monticello - Monticello, NY
Monticello Municipal Airport - Monticello, IA
Monticello Municipal/Ellis - Monticello, AR
Montrose Regional Airport - Montrose, CO
Montvale Airport - Montvale, NJ
Monument Municipal - Monument, OR
Monument Valley Airport - Kayenta, AZ
Monument Valley Airport - Monument Valley Gouldings, UT
Moody Air Force Base - Valdosta, GA
Moontown - Huntsville, AL
Moore - Lexington, MS
Moore Co - Dumas, TX
Moore-Murrell Airport - Morristown, TN
Mooreland Municipal - Mooreland, OK
Moores - Degrasse, NY
Moorestown - Moorestown, MI
Moorhead - North East, PA
Moorhead Municipal - Moorhead, MN
Moose Creek Usfs - Moose Creek Ranger Stn, ID
Moose Lake/Carlton Co - Moose Lake, MN
Mora Municipal - Mora, MN
Moraine Air Park - Dayton, OH
Morehead-Rowan Co - Morehead, KY
Morehouse Memorial - Bastrop, LA
Morenci Airport - Clifton, AZ
Morey'S - Motley, MN
Morgan - Morgan, MT
Morgan Co - Mc Connelsville, OH
Morgan Co - Morgan, UT
Morgantown - Morgantown, PA
Morgantown Airport - Morgantown, WV
Moriarty - Moriarty, NM
Morningstar - Des Moines, IA
Morrilton Municipal - Morrilton, AR
Morris Army Air Field - Forest Park, GA
Morris Mun-Washburn - Morris, IL
Morris Municipal Airport - Morris, MN
Morristown Municipal Airport - Morristown, NJ
Morrisville-Stowe Airport - Stowe, VT
Morrow Co - Mt Gilead, OH
Morse State - Bennington, VT
Moscow Regional Airport - Pullman, WA
Moser Bay Airport - Moser Bay, AK
Moses Lake Municipal - Moses Lake, WA
Moses Point Intermediate Airport - Moses Point, AK
Moton Municipal - Tuskegee, AL
Mott Municipal - Mott, ND
Moultonboro - Moultonboro, NH
Moundridge Municipal - Moundridge, KS
Moundville - Moundville, AL
Mount Mckinley Airport - Mount McKinley, AK
Mount Olive Municipal Airport - Mt Olive, NC
Mount Pleasant Airport - Mount Pleasant, TX
Mount Pleasant Municipal Airport - Mount Pleasant, IA
Mount Pleasant Municipal Airport - Mount Pleasant, MI
Mount Pocono Airport - Mount Pocono, PA
Mount Snow - West Dover, VT
Mount Union Airport - Mount Union, PA
Mount Wilson Airport - Mount Wilson, CA
Mountain Empire - Marion-Wytheville, VA
Mountain Grove Memorial - Mountain Grove, MO
Mountain Home Air Force Base - Mountain Home, ID
Mountain Home Airport - Mountain Home, AR
Mountain Home Municipal - Mountain Home, ID
Mountain Lakes - Helena, MT
Mountain Meadow Airstrip - Burlington, CT
Mountain Valley - Tehachapi, CA
Mountain View - Mountain View, MO
Mountain View Wilcox Memorial - Mountain View, AR
Mountain Village Airport - Mountain Village, AK
Mountainair Municipal - Mountainair, NM
Mt Airy-Surry Co - Mt Airy, NC
Mt Carmel Municipal - Mt Carmel, IL
Mt Comfort Airport - Indianapolis, IN
Mt Hawley Aux - Peoria, IL
Mt Pleasant-Scottdale - Mt Pleasant, PA
Mt Sterling Municipal - Mt Sterling, IL
Mt Sterling-Montgomery Co - Mount Sterling, KY
Mt Vernon Municipal - Mt Vernon, MO
Mt Vernon-Outland Airport - Mount Vernon, IL
Mt. Pleasant Airport - Mount Pleasant, UT
Mud Lake - Mud Lake, ID
Mudhole Smith Airport - Cordova, AK
Muhlenberg Co - Greenville, KY
Muir Aaf - Ft Indiantown Gap, PA
Muleshoe Municipal - Muleshoe, TX
Mullen Airport - Mullen, NE
Munday Mun - Munday, TX
Murdo Municipal - Murdo, SD
Murdock Municipal - Murdock, MN
Murfreesboro Municipal Airport - Murfreesboro, TN
Murphy - Murphy, ID
Murphy Hot Springs - Three Creek, ID
Murray Field - Eureka, CA
Muscatine Airport - Muscatine, IA
Muscle Shoals Airport - Muscle Shoals, AL
Muskegon Airport - Muskegon, MI
Mustang Beach - Port Aransas, TX
Mustin Airfield - Philadelphia, PA
Myers - Canby, MN
Myricks - Berkley, MA
Myrtle Beach International Airport - Myrtle Beach, SC
Myrtle Creek Municipal - Myrtle Creek, OR
Nacogdoches Airport - Nacogdoches, TX
Naec Airport - Lakehurst, NJ
Nakeen - Nakeen, AK
Naknek Airport - Naknek, AK
Nakolik River Airport - Nakolik River, AK
Nakuati Bay Seaplane Base - Tuxekan Island, AK
Nampa Municipal - Nampa, ID
Nantucket Memorial Airport - Nantucket, MA
Nanwalek Airport - Nanwalek, AK
Napa County Airport - Napa, CA
Napakiak Sea Plane Base - Napakiak, AK
Napaskiak Sea Plane Base - Napaskiak, AK
Naper Aero Club - Naperville, IL
Naples Airport - Naples, FL
Napoleon Airport - Napoleon, MI
Napoleon Municipal - Napoleon, ND
Nappanee Municipal - Nappanee, IN
Nary Natl-Shefland - Nary, MN
NASA Crows Landing Airport - Crows Landing, CA
Nasa Shuttle Landing Facility - Titusville, FL
Nashville International Airport - Nashville, TN
Natchitoches Regional - Natchitoches, LA
Natomas Airport - Sacramento, CA
Naukiti Airport - Naukiti, AK
Navajo - Arboles, CO
Navajo State Park - Navajo Dam, NM
Naval Air Field - Dahlgren, VA
Naval Air Station - Brunswick, ME
Naval Air Station - Corpus Christi, TX
Naval Air Station - Fallon, NV
Naval Air Station - Glynco, GA
Naval Air Station - Kingsville, TX
Naval Air Station - Memphis, TN
Naval Air Station - Oceana, VA
Naval Air Station - Patuxent River, MD
Naval Air Station - Quonset Point, RI
Naval Air Station Chambers - Norfolk, VA
Naval Air Station Great Lakes - Chicago, IL
Naval Air Station Key West - Key West, FL
Naval Air Station Pensacola - Pensacola, FL
Naval Air Station/Alvin Callendar - New Orleans, LA
Naval Air Station/Reeves Field - Lemoore, CA
Navasota Municipal - Navasota, TX
Navy Air Facility El Centro - El Centro, CA
Nebraska City Municipal - Nebraska City, NE
Necedah - Necedah, WI
Needles Airport - Needles, CA
Nehalem Bay State - Manzanita, OR
Neil Armstrong Airport - Wapakoneta, OH
Neillsville Municipal - Neillsville, WI
Nellis Air Force Base - Las Vegas, NV
Nelson Lagoon Airport - Nelson Lagoon, AK
Nenana Municipal Airport - Nenana, AK
Neodesha Municipal - Neodesha, KS
Neosho Airport - Neosho, MO
Nephi Airport - Nephi, UT
Nervino - Beckwourth, CA
Ness City Municipal - Ness City, KS
Nevada Airport - Nevada, MO
Nevada Co - Grass Valley, CA
New Albany-Union Co - New Albany, MS
New Allakaket - Allakaket, AK
New Bedford Airport - New Bedford, MA
New Braunfels Municipal - New Braunfels, TX
New Castle Airport - Wilmington, DE
New Castle Municipal - New Castle, PA
New Castle-Henry Co Municipal - New Castle, IN
New Century Aircenter - Kansas City, MO
New Chenega Airport - New Chenega, AK
New Coalinga Municipal - Coalinga, CA
New Cuyama - New Cuyama, CA
New Garden - Toughkenamon, PA
New Hampton Municipal - New Hampton, IA
New Hanover - New Hanover, PA
New Haven Airport - New Haven, CT
New Hibiscus - Vero Beach, FL
New Holstein Municipal - New Holstein, WI
New Hudson - New Hudson, MI
New Jerusalem - Tracy, CA
New Kent Co - Quinton, VA
New Koliganek Airport - New Koliganek, AK
New London - Forest, VA
New Market - New Market, VA
New Meadows - New Meadows, ID
New Richmond Municipal Airport - New Richmond, WI
New River Mcas - Jacksonville, NC
New River Valley Airport - Dublin, VA
New Smyrna Beach Municipal - New Smyrna Beach, FL
New Stuyahok Airport - New Stuyahok, AK
New Tazewell Municipal - Tazewell, TN
New Town Municipal - New Town, ND
New Ulm Airport - New Ulm, MN
New Warden - Warden, WA
New York 39th St Ferry - New York, NY
New York Downtown Manhattan Heliport - New York, NY
New York Mills Municipal - New York Mills, MN
Newark Heath - Newark, OH
Newark Liberty International Airport - Newark, NJ
Newberry Municipal - Newberry, SC
Newellton - Newellton, LA
Newfound Valley - Bristol, NH
Newlon - Huntington, WV
Newman'S - Kalamazoo, MI
Newnan-Coweta County Airport - Newnan, GA
Newport Airport - Newport, OR
Newport Airport - Newport, VT
Newport Beach Heliport - Newport Beach, CA
Newport Municipal - Newport, AR
Newport News/Williamsburg International Airport - Newport News, VA
Newtok Airport - Newtok, AK
Newton - Jackman, ME
Newton - Newton, NJ
Newton City-County Airport - Newton, KS
Newton Municipal - Newton, TX
Newton Municipal Airport - Newton, IA
Nez Perce County Regional Airport - Lewiston, ID
Nez Perce Municipal - Nez Perce, ID
Niagara Falls International Airport - Niagara Falls, NY
Niblack Airport - Niblack, AK
Nichen Cove Airport - Nichen Cove, AK
Nichols - La Porte City, IA
Nightmute Airport - Nightmute, AK
Nikolai Airport - Nikolai, AK
Nikolski Air Force Station - Nikolski, AK
Ninilchik Airport - Ninilchik, AK
Nixon Memorial - Chesaning, MI
Noatak Airport - Noatak, AK
Noble Co - Caldwell, OH
Noble F. Lee Airport - Minocqua, WI
Noblesville Airport - Noblesville, IN
Nocona - Nocona, TX
Nogales International Airport - Nogales, AZ
Nolan - Jonesboro, AR
NOLF Imperial Beach - Imperial Beach, CA
Nome Airport - Nome, AK
Nome City - Nome, AK
Nondalton Airport - Nondalton, AK
Norfolk Airport - Norfolk, MA
Norfolk International Airport - Norfolk, VA
Norman Co Ada/Twin Valley - Ada/Twin Valley, MN
Norman Y. Mineta San Jose International Airport - San Jose, CA
North Bass Island Airport - North Bass Island, OH
North Bend Airport - North Bend, OR
North Big Horn Co - Cowley-Lovell-Byron, WY
North Buffalo Suburban - Lockport, NY
North Central Airport - Smithfield, RI
North Fork Valley Airport - Paonia, CO
North Island Naval Air Station - San Diego, CA
North Las Vegas Airport - Las Vegas, NV
North Little Rock Municipal - Little Rock, AR
North Omaha Airport - Omaha, NE
North Palm Beach Co Gen Avn - West Palm Beach, FL
North Park Inn Heliport - Dallas, TX
North Perry Airport - Hollywood, FL
North Philadelphia Airport - Philadelphia, PA
North Pickens - Reform, AL
North Rim Airport - Grand Canyon, AZ
North Shore Airport - Umnak Island, AK
North Vernon Airport - North Vernon, IN
North Windham - Londonderry, VT
Northampton - Northampton, MA
Northeast Cape Air Force Station - Northeast Cape, AK
Northern Airport - Tullahoma, TN
Northome Municipal - Northome, MN
Northumberland Co - Shamokin, PA
Northway Airport - Northway, AK
Northwest Arkansas Regional Airport - Bentonville, AR
Northwest Florida Beaches International Airport - Panama City, FL
Northwest Florida Regional Airport - Fort Walton Beach, FL
Northwest Regional - Roanoke, TX
Northwood Mun-Vince - Northwood, ND
Northwood Municipal - Northwood, IA
Norton Air Force Base - San Bernardino, CA
Norton Municipal - Norton, KS
Norwalk Heliport - Norwalk, CT
Norwalk Huron County Airport - Norwalk, OH
Norwich - Norwich, KS
Norwood Memorial Airport - Norwood, MA
Novato Airport - Novato, CA
Nowata Municipal - Nowata, OK
Nueces Co - Robstown, TX
Nuiqsut Airport - Nuiqsut, AK
Nulato Airport - Nulato, AK
Nunapitchuk Airport - Nunapitchuk, AK
Nut Tree - Vacaville, CA
Nyac Airport - Nyac, AK
O'Hare International Airport - Chicago, IL
O'Neill Municipal Airport - O'Neill, NE
O'Sullivan Army Heliport - San Luis Obispo, CA
Oak Harbor Airport - Oak Harbor, WA
Oakdale - Oakdale, CA
Oakes Municipal - Oakes, ND
Oakland/Coliseum Station - Oakland, MD
Oakland/Troy - Troy, MI
Oakley Municipal - Oakley, ID
Oakley Municipal - Oakley, KS
Oakridge State - Oakridge, OR
Oberlin Municipal - Oberlin, KS
Obie - Chinook, MT
Ocean City Municipal - Ocean City, NJ
Ocean City Municipal Airport - Ocean City, MD
Ocean Isle - Ocean Isle Beach, NC
Ocean Reef Airport - Ocean Reef, FL
Ocean Reef Club - Key Largo, FL
Ocean Ridge - Gualala, CA
Ocean Shores Municipal - Ocean Shores, WA
Ocean Springs - Ocean Springs, MS
Oceana Co - Hart/Shelby, MI
Oceanic Airport - Oceanic, AK
Oceano Co - Oceano, CA
Oceanside Municipal Airport - Oceanside, CA
Oconee County Airport - Clemson, SC
Oconto Municipal - Oconto, WI
Ocotillo - Ocotillo Wells, CA
Ocracoke I - Ocracoke, NC
Odessa Municipal - Odessa, WA
Odessa-Schlemeyer - Odessa, TX
Oelwein Municipal - Oelwein, IA
Offutt Air Force Base - Omaha, NE
Ogden Municipal Airport - Ogden, UT
Ogdensburg Airport - Ogdensburg, NY
Ohio Co - Hartford, KY
Ohio County Airport - Wheeling, WV
Ohio Dusting Co Inc - Pandora, OH
Ohio State University Airport - Columbus, OH
Ohio University Airport - Athens, OH
Ojibwa - Weidman, MI
Okanogan Legion - Okanogan, WA
Okeechobee County Airport - Okeechobee, FL
Okeene Municipal - Okeene, OK
Okemah - Okemah, OK
Oklahoma City Downtown Airpark - Oklahoma City, OK
Okmulgee Airport - Okmulgee, OK
Okolona Mun-Stovall - Okolona, MS
Oktibbeha - Starkville, MS
Olcott-Newfane - Olcott, NY
Old Bridge - Old Bridge, NJ
Old Harbor Sea Plane Base - Old Harbor, AK
Old Hoppe Place - Agua Dulce, TX
Old Mans - Pedrictown, NJ
Old Sawyer International - Marquette, MI
Old Town Airport - Old Town, ME
Oldham Co - Vega, TX
Olean Municipal Airport - Olean, NY
Olf Usn Airport - Whitehouse, FL
Olga Bay Sea Plane Base - Olga Bay, AK
Oliktok Lrrs - Oliktok Point, AK
Olive Branch Airport - Olive Branch, MS
Olive Hill-Seller'S - Olive Hill, KY
Olivia Regional - Olivia, MN
Olla - Olla, LA
Olney Airport - Olney, IL
Olney Airport - Olney, TX
Olustee Municipal - Olustee, OK
Olympia Airport - Olympia, WA
Omak Municipal Airport - Omak, WA
Ona - Milton, WV
Oneal Airport - Vincennes, IN
Oneida County Airport - Rhinelander, WI
Oneida County Airport - Utica, NY
Oneonta Municipal Airport - Oneonta, NY
Onida Municipal - Onida, SD
Onion Bay Airport - Onion Bay, AK
Ontario Airport - Ontario, OR
Ontario International Heliport - Ontario, CA
Ontonagon Co - Ontonagon, MI
Opa Locka - Miami, FL
Opa Locka West Airport - Miami, FL
Opheim - Opheim, MT
Orange City Municipal - Orange City, IA
Orange Co - Orange, TX
Orange Co - Orange, VA
Orange County Airport - Montgomery, NY
Orange Grove Nalf - Orange Grove, TX
Orange Municipal - Orange, MA
Orangeburg Municipal Airport - Orangeburg, SC
Orcas Island Airport - Eastsound, WA
Orchard Park Airport - Orchard Park, NY
Orlando Country - Plymouth, FL
Orlando Executive Airport - Orlando, FL
Orlando International Airport - Orlando, FL
Orlando Sanford International Airport - Orlando, FL
Orleans - Orleans, IN
Ormond Beach Municipal - Ormond Beach, FL
Orofino Municipal - Orofino, ID
Orogrande - Orogrande, ID
Oroville Airport - Oroville, CA
Orr Regional - Orr, MN
Ortonville Mun-Martinson - Ortonville, MN
Osage City Municipal - Osage City, KS
Osage Municipal - Osage, IA
Osceola Municipal - Osceola, AR
Osceola Municipal - Osceola, IA
Osceola Municipal - Osceola, MO
Osceola Municipal Airport - Osceola, WI
Oscoda Co - Mio, MI
Oshkosh Airport - Oshkosh, NE
Oskaloosa Municipal Airport - Oskaloosa, IA
Oswego Co - Fulton, NY
Othello Municipal - Othello, WA
Otis Air Force Base - Falmouth, MA
Otsego County Airport - Gaylord, MI
Ottawa Executive - Zeeland, MI
Ottawa Municipal - Ottawa, KS
Outagamie County Airport - Appleton, WI
Outlaw Field - Clarksville, TN
Ouzinkie Sea Plane Base - Ouzinkie, AK
Ovid - Ovid, NY
Owatonna Airport - Owatonna, MN
Owen - Seymour, MO
Owens Field - Columbia, SC
Owosso Community - Owosso, MI
Owyhee - Owyhee, NV
Owyhee Reservoir State - Owyhee, OR
Oxford - Oxford, MA
Oxford Co Regional - Oxford, ME
Oxford Municipal - Oxford, KS
Oxnard Airport - Oxnard, CA
Oyster Cove - Homer, AK
Ozark-Franklin Co - Ozark, AR
Ozona Airport - Ozona, TX
P K Airpark - Raeford, NC
Pack Creek Airport - Pack Creek, AK
Packer - Radnor, OH
Packwood - Packwood, WA
Padgham - Allegan, MI
Paf Cannery - South Naknek, AK
Paf Warren Airport - Paf Warren, AK
Page Airport - Page, AZ
Page Field - Fort Myers, FL
Page Municipal - Oklahoma City, OK
Pageland - Pageland, SC
Paimiut Sea Plane Base - Paimiut, AK
Painter Creek Airport - Painter Creek, AK
Paintsville-Prestonsburg-Combs - Paintsville, KY
Paisley State - Paisley, OR
Pal-Waukee Airport - Chicago, IL
Palacios Airport - Palacios, TX
Palestine Airport - Palestine, TX
Palm Beach County Airport - West Palm Beach, FL
Palm Beach County Glades Airport - Pahokee, FL
Palm Springs Municipal Airport - Palm Springs, CA
Palmdale Air Force 42 Base - Palmdale, CA
Palmer - Ponder, TX
Palmer Metropolitan Airport - Palmer, MA
Palmer Municipal Airport - Palmer, AK
Palmyra Municipal - Palmyra, WI
Palo Alto Airport of Santa Clara County - Palo Alto, CA
Palo Duro - Amarillo, TX
Pam'S Place - Eminence, IN
Pangborn Field - Wenatchee, WA
Panguitch Airport - Panguitch, UT
Panhandle-Carson Co - Panhandle, TX
Panola Co - Batesville, MS
Panola Co-Sharpe - Carthage, TX
Paoli Municipal - Paoli, IN
Papago Air Force Base - Phoenix, AZ
Paradise Skypark - Paradise, CA
Paragould Municipal Airport - Paragould, AZ
Paris Municipal - Paris/Subiaco, AR
Park Falls Airport - Park Falls, WI
Park Rapids Airport - Park Rapids, MN
Park River-Skjerven - Park River, ND
Park Township Airport - Holland, MI
Parker Carson - Carson City, NV
Parker County Airport - Weatherford, TX
Parks Sea Plane Base - Parks, AK
Parkston Municipal - Parkston, SD
Parlin Field Airport - Newport, NH
Parma - Parma, ID
Parowan - Parowan, UT
Parr - Zanesville, OH
Parshall-Hankins - Parshall, ND
Parsons - Carrollton, OH
Pasadena Heliport - Pasadena, CA
Paso Robles Airport - Paso Robles, CA
Patrick Air Force Base - Cocoa, FL
Patterson Air Force Base - Dayton, OH
Patterson Municipal Heliport - Patterson, LA
Patty - El Dorado, KS
Paullina Municipal - Paullina, IA
Pauloff Harbor Sea Plane Base - Pauloff Harbor, AK
Pauls Valley Municipal - Pauls Valley, OK
Pawhuska Municipal - Pawhuska, OK
Pawnee City Municipal - Pawnee City, NE
Pawnee Municipal - Pawnee, OK
Paxson - Paxson, AK
Paxton - Paxton, IL
Payette Municipal - Payette, ID
Payson Airport - Payson, AZ
Pbeaaye - Topinabee, MI
Peach Springs Airport - Peach Springs, AZ
Peach State - Williamson, GA
Peachtree City-Falcon - Atlanta, GA
Peachtree-Dekalb Airport - Atlanta, GA
Pearce Ferry - Meadview, AZ
Pearl River County Airport - Picayune, MS
Pearland Regional Airport - Houston, TX
Pearson Field - Vancouver, WA
Pease Air Force Base - Portsmouth, NH
Peconic River Airport - Calverton, NY
Pecos City Airport - Pecos City, TX
Pecos County Airport - Fort Stockton, TX
Pedro Bay Airport - Pedro Bay, AK
Pekin Municipal - Pekin, IL
Pelican Rapids Mun-Lyon'S - Pelican Rapids, MN
Pelican Sea Plane Base - Pelican, AK
Pella Municipal - Pella, IA
Pemberton Airport - Pemberton, NJ
Pembina Intermediate Airport - Pembina, ND
Pender Municipal - Pender, NE
Penn Valley Airport - Selinsgrove, PA
Penn Yan - Penn Yan, NY
Pennridge Airport - Perkasie, PA
Penns Cave - Centre Hall, PA
Pensacola International Airport - Pensacola, FL
Pentagon Army Airport - Washington, DC
Perham Municipal - Perham, MN
Perimeter Mall Heliport - Atlanta, GA
Perkins - Overton, NV
Perkins Memorial - Chambers, NE
Perkiomen Valley - Collegeville, PA
Perris Valley Airport - Perris, CA
Perry - Goldsby, OK
Perry Co - Linden, TN
Perry Co - New Lexington, OH
Perry Co Municipal - Tell City, IN
Perry Lefors Field - Pampa, TX
Perry Municipal - Perry, OK
Perry Municipal Airport - Perry, IA
Perry Sea Plane Base - Perry Island, AK
Perry-Foley Airport - Perry, FL
Perry-Houston Co - Perry, GA
Perry-Warsaw - Perry, NY
Perryton Ochiltree Co - Perryton, TX
Perryville Airport - Perryville, AK
Person County Airport - Roxboro, NC
Peru Municipal - Peru, IN
Petaluma Municipal - Petaluma, CA
Peter O'Knight Airport - Tampa, FL
Petersburg Municipal Airport - Petersburg, AK
Peterson - Plains, GA
Peterson's Point Airport - Peterson's Point, AK
Petit Jean Park Airport - Morrilton, AR
Phifer Field - Wheatland, WY
Philadelphia International Airport - Philadelphia, PA
Philadelphia Municipal - Philadelphia, MS
Philadelphia Rail Station - Philadelphia, PA
Philadelphia Sea Plane Base - Philadelphia, PA
Philip Billard Airport - Topeka, KS
Philippi/Barbour Co Regional - Philippi, WV
Phillip Airport - Philip, SD
Phillips Army Air Field - Aberdeen, MD
Phillips Field - Fairbanks, AK
Phillips Flying Ranch - Rockwall, TX
Phillipsburg - Phillipsburg, OH
Phillipsburg Municipal - Phillipsburg, KS
Phoenix Goodyear Airport - Goodyear, AZ
Phoenix Sky Harbor International Airport - Phoenix, AZ
Phoenix-Deer Valley Airport - Phoenix, AZ
Phoenix-Mesa Gateway Airport - Chandler, AZ
Phoenix-Mesa Gateway Airport - Mesa, AZ
Piatt Co - Monticello, IL
Picabo - Picabo, ID
Picayune Municipal - Picayune, MS
Pickaway Co Memorial - Circleville, OH
Pickens Airport - Pickens, SC
Pickens Co - Jasper, GA
Piedmont Municipal - Piedmont, MO
Piedmont Triad International Airport - Greensboro/High Point, NC
Pier 11-Wall St Sea Plane Base - New York, NY
Pierce Co-Thun - Puyallup, WA
Pierre Airport - Pierre, SD
Pierson Municipal - Pierson, FL
Piggott Municipal - Piggott, AR
Pike Co - Waverly, OH
Pike Co-Hatcher - Pikeville, KY
Pike County Airport - Mc Comb, MS
Pilot Country Airport - Brooksville, FL
Pilot Point Airport - Pilot Point, AK
Pilot Station Airport - Pilot Station, AK
Pinckneyville-Du Quoin - Pinckneyville, IL
Pine - Pine, ID
Pine Bluffs Municipal - Pine Bluffs, WY
Pine City Municipal - Pine City, MN
Pine Hill - Albion, NY
Pine Hill Municipal - Pine Hill, AL
Pine Island Airport - Duck, NC
Pine Mountain Lake - Groveland, CA
Pine Ridge Airport - Pine Ridge, SD
Pine River Regional - Pine River, MN
Pinehurst State - Pinehurst, OR
Pinehurst-S. Pines Airport - Southern Pines, NC
Pineland Municipal - Pineland, TX
Pineville Municipal - Pineville, LA
Piney Pinecreek Border Airport - Pinecreek, MN
Pink Hill - Pink Hill, NC
Pioneer Village - Minden, NE
Pipestone Municipal - Pipestone, MN
Piqua - Piqua, OH
Piso - Suring, WI
Pitt-Greenville Airport - Greenville, NC
Pittman Memorial - Tylertown, MS
Pittsburg Municipal Airport - Pittsburg, KS
Pittsburgh International Airport - Pittsburgh, PA
Pittsburgh-Monroeville - Monroeville, PA
Pittsfield Airport - Pittsfield, MA
Pittsfield Municipal - Pittsfield, ME
Pittsfield Penstone Municipal - Pittsfield, IL
Placerville Airport - Placerville, CA
Plains - Plains, MT
Plainville - Plainville, KS
Plainwell Municipal - Plainwell, MI
Plant City Municipal Airport - Plant City, FL
Plantation - Sylvania, GA
Plateau Sky Ranch - Edinburg, NY
Platinum Airport - Platinum, AK
Platte Municipal - Platte, SD
Platte Valley - Hudson, CO
Platteville Municipal - Platteville, WI
Plattsburg - Plattsburg, MO
Plattsburgh Air Force Base - Plattsburgh, NY
Plattsburgh International - Plattsburgh, NY
Plattsmouth Municipal - Plattsmouth, NE
Pleasant Harbor Airport - Pleasant Harbor, AK
Pleasanton Municipal - Pleasanton, TX
Plum Island - Newburyport, MA
Plymouth Airport - Plymouth, IN
Plymouth Airport - Plymouth, MA
Plymouth Municipal - Plymouth, NC
Plymouth Municipal - Plymouth, NH
Pocahontas Municipal Airport - Pocahontas, IA
Pocatello Airport - Pocatello, ID
Pogue Municipal - Sand Springs, OK
Point Baker Sea Plane Base - Point Baker, AK
Point Barrow Airport - Barrow, AK
Point Hope Airport - Point Hope, AK
Point Mc Intyre - Point Mc Intyre, AK
Point Mugu Naval Air Station - Port Hueneme, CA
Polacca Airport - Polacca, AZ
Polk Army Air Field - Fort Polk, LA
Polk Inlet Airport - Polk Inlet, AK
Pollock Municipal - Pollock, LA
Polson - Polson, MT
Pomona Lake - Lyndon, KS
Pompano Beach Airport - Pompano Beach, FL
Ponca City Regional Airport - Ponca City, OK
Pond Creek Municipal - Pond Creek, OK
Pontiac Airport - Pontiac, MI
Pontiac Municipal - Pontiac, IL
Pontotoc Co - Pontotoc, MS
Pool/Weaverville - Weaverville, CA
Pope Field - Fayetteville, NC
Pope Field - Greenfield, IN
Pope Vanoy Airport - Pope Vanoy, AK
Poplar - Poplar, MT
Poplar Grove - Poplar Grove, IL
Poplarville-Pearl River Co - Poplarville, MS
Porcupine Creek Airport - Porcupine Creek, AK
Port Alexander Airport - Port Alexander, AK
Port Alice Airport - Port Alice, AK
Port Allen Airport - Hanapepe, HI
Port Alsworth Airport - Port Alsworth, AK
Port Angeles Cgas - Port Angeles, WA
Port Armstrong Airport - Port Armstrong, AK
Port Authority-West 30Th St. Midtown. (Hel - New York, NY
Port Bailey Sea Plane Base - Port Bailey, AK
Port Bucyrus-Crawford Co - Bucyrus, OH
Port Clarence Airport - Port Clarence, AK
Port Columbus International Airport - Columbus, OH
Port Frederick Airport - Port Frederick, AK
Port Graham Airport - Port Graham, AK
Port Heiden Airport - Port Heiden, AK
Port Isabel-Cameron Co - Port Isabel, TX
Port Johnson Airport - Port Johnson, AK
Port Largo Airport - Key Largo, FL
Port Lions Sea Plane Base - Port Lions, AK
Port Moller Air Force Station - Port Moller, AK
Port Oceanic Airport - Port Oceanic, AK
Port Of Ilwaco - Ilwaco, WA
Port Protection Airport - Port Protection, AK
Port San Juan Airport - Port San Juan, AK
Port Townsend Airport - Port Townsend, WA
Port Walter Airport - Port Walter, AK
Port Williams Sea Plane Base - Port Williams, AK
Portage Co - Ravenna, OH
Portage Creek Airport - Portage Creek, AK
Portage Municipal - Portage, WI
Portales Municipal - Portales, NM
Porter County Airport - Valparaiso, IN
Porterville Airport - Porterville, CA
Porthill Eckhart International - Porthill, ID
Portland Hillsboro Airport - Hillsboro, OR
Portland International Airport - Portland, OR
Portland International Jetport - Portland, ME
Portland Municipal - Portland, IN
Portland Municipal - Portland, TN
Portland-Mulino - Portland, OR
Portsmouth Regional Airport - Portsmouth, OH
Posey - Haleyville, AL
Poso-Kern Co - Famoso, CA
Possum Kingdom - Graford, TX
Post Aaf - Ft Sill, OK
Post Air Airport - Indianapolis, IN
Post Mills - Post Mills, VT
Post-Garza Co Municipal - Post, TX
Potoczak - Clarence Center, NY
Potomac - Berkeley Springs, WV
Potomac Airfield - Friendly, MD
Potsdam Municipal - Potsdam, NY
Pottstown Municipal - Pottstown, PA
Pottstown/Limerick Airport - Pottstown, PA
Poulsbo Airport - Poulsbo, WA
Pounds Field - Tyler, TX
Powell - Danville, KY
Powell - Knoxville, TN
Powell/Lovell Airport - Powell/Lovell, WY
Powers State - Powers, OR
Prague Municipal - Prague, OK
Prairie Du Chien Municipal Airport - Prairie Du Chien, WI
Prairie Ronde - Schoolcraft, MI
Pratt Airport - Pratt, KS
Pratt'S Eastern Divide - Sherman, NY
Prentice Airport - Prentice, WI
Prentiss-Jefferson Davis Co - Prentiss, MS
Prescott Airport - Prescott, AZ
Presho Municipal - Presho, SD
Presidio Lely International - Presidio, TX
Presque Isle Co - Rogers City, MI
Presque Isle Municipal Airport - Presque Isle, ME
Preston - Preston, ID
Preston-Glenn Field - Lynchburg, VA
Price Co - Phillips, WI
Price Ranch - Mt Dora, NM
Prices - Linden, MI
Prichard - Enterprise, KS
Prickett-Grooms - Sidnaw, MI
Priebe - Findlay, OH
Priest Lake Usfs - Nordman, ID
Priest River Municipal - Priest River, ID
Primghar - Primghar, IA
Prince - Milton, FL
Princeton Airport - Princeton, ME
Princeton Airport - Princeton, NJ
Princeton Municipal - Princeton, MN
Princeton-Caldwell Co - Princeton, KY
Princeton-Kauffman Memorial - Princeton, MO
Princeville Airport - Kauai Island, HI
Prineville Airport - Prineville, OR
Pronger Bros Ranch - Stratford, TX
Prospect Creek Airport - Prospect Creek, AK
Prospect State - Prospect, OR
Prosser - Prosser, WA
Providence-Webster Co - Providence, KY
Provincetown Airport - Provincetown, MA
Provo Airport - Provo, UT
Pru - Ritzville, WA
Prudhoe Bay Airport - Prudhoe Bay, AK
Prudhoe Bay/Deadhorse Airport - Prudhoe Bay/Deadhorse, AK
Pruetz Municipal - Kulm, ND
Puckett - Eagleville, TN
Pueblo Memorial Airport - Pueblo, CO
Pueblo Pintado - Pueblo Pintado, NM
Pulaski County Airport - Somerset, KY
Punxsutawney Municipal - Punxsutawney, PA
Purcell Municipal - Purcell, OK
Purdue University Airport - Lafayette, IN
Purkeypile - Purkeypile, AK
Put-In-Bay Airport - Put-In-Bay, OH
Putnam Co - Greencastle, IN
Putnam Co - Ottawa, OH
Pyor Airport - Decatur, AL
Quad-City Airport - Moline, IL
Quail Creek - Quail Creek, AK
Quanah Municipal - Quanah, TX
Quantico Naval Air Station - Quantico, VA
Quart Creek Airport - Cooper Lodge, AK
Quartz Creek Kougarok - Quartz Creek, AK
Quartz Hill Airport - Lancaster, CA
Queen Airport - Queen, AK
Questa Mun Nr 2 - Questa, NM
Quillayute State Airport - Quillayute, WA
Quincy Airport - Quincy, MA
Quincy Municipal - Quincy, FL
Quincy Municipal - Quincy, WA
Quincy Municipal Airport - Quincy, IL
Quinn - Gothenburg, NE
Quitman-Brooks Co - Quitman, GA
Quonset State - North Kingstown, RI
R & K Skyranch - Rochester, WA
Raether - Howell, MI
Rainbow Air Village - Dearborn, MO
Rainy Pass - Rainy Pass, AK
Raleigh Airport - Harrisburg, IL
Raleigh East Airport - Knightdale, NC
Raleigh Exec Jetport at Sanford-Lee County - Sanford, NC
Raleigh-Durham International Airport - Raleigh/Durham, NC
Ralph Calhoun Airport - Tanana, AK
Ralph Wenz Field - Pinedale, WY
Ramona Airport - Ramona, CA
Rampart Airport - Rampart, AK
Ranchaero - Chico, CA
Rancho Murieta Airport - Sacramento, CA
Randall - Middletown, NY
Randolph - Randolph, NY
Randolph Air Force Base - San Antonio, TX
Randolph Co - Winchester, IN
Randolph'S Landing Area - St Johns, MI
Rangeley Municipal - Rangeley, ME
Rangely Airport - Rangely, CO
Ranger Creek - Greenwater, WA
Ranger Municipal Airport - Ranger, TX
Rankin - Maryville, MO
Rankin - Rankin, TX
Rantoul Natl Aviation Ctr-Liot - Rantoul, IL
Rapid City Regional Airport - Rapid City, SD
Rasor - Avoca, MI
Raspberry Strait Airport - Raspberry Strait, AK
Ravalli Co - Hamilton, MT
Ravendale - Ravendale, CA
Rawlins Airport - Rawlins, WY
Ray - Bayou La Batre, AL
Ray - Chappell, NE
Reading Municipal Airport/Spaatz Field - Reading, PA
Reagan Co - Big Lake, TX
Real Co - Leakey, TX
Rector - Rector, AR
Red Bluff FSS - Red Bluff, CA
Red Cloud Municipal - Red Cloud, NE
Red Devil Airport - Red Devil, AK
Red Dog Airport - Red Dog, AK
Red Lake Falls Municipal - Red Lake Falls, MN
Red Lion - Vincentown, NJ
Red Lodge - Red Lodge, MT
Red Oak Municipal - Red Oak, IA
Red Wing Municipal - Red Wing, MN
Redding Airport - Redding, CA
Redfield Municipal - Redfield, SD
Redlands Municipal - Redlands, CA
Redstone Army Air Field - Huntsville, AL
Redwing Airport - Jobstown, NJ
Redwood Falls Municipal Airport - Redwood Falls, MN
Reedley Municipal - Reedley, CA
Reedsburg Municipal - Reedsburg, WI
Reelfoot Lake - Tiptonville, TN
Reese - Muncie, IN
Reese Air Force Base - Lubbock, TX
Reeves - Tallassee, AL
Rehoboth Beach Airport - Rehoboth Beach, DE
Reid Hillview of Santa Clara County Airport - San Jose, CA
Reidsville - Reidsville, GA
Reigle - Palmyra, PA
Reilly Army Heliport - Anniston, AL
Remer Municipal - Remer, MN
Renner Field - Goodland, KS
Reno/Stead - Reno, NV
Reno/Tahoe International Airport - Reno, NV
Rensselaer Airport - Rensselaer, IN
Rensselaer Co - Troy, NY
Renton Airport - Renton, WA
Rentschler Airport - East Hartford, CT
Rep Airport - Mount Shasta, CA
Republic Field - Farmingdale, NY
Reserve - Reserve, NM
Resnick - Ellenville, NY
Rexburg-Madison Co - Rexburg, ID
Reynolds Airport - Richfield, UT
Reynolds Municipal Airport - Jackson, MI
Reynolds/North Mobile Co - Creola, AL
Rhodes - Jackson, OH
Rialto Municipal/Miro - Rialto, CA
Rice County Municipal Airport - Lyons, KS
Rice Lake Airport - Rice Lake, WI
Richard B Russell Airport - Rome, GA
Richard I Bong Airport - Superior, WI
Richard Lloyd Jones Jr Airport - Tulsa, OK
Richards Field - Massena, NY
Richards Municipal - Paducah, TX
Richards-Gebaur Airport - Grandview, MO
Richardton - Richardton, ND
Richey - Richey, MT
Richland - Richland Center, WI
Richland Airport - Richland, WA
Richland Municipal - Richland, MO
Richland Municipal Airport - Sidney, MT
Richmond - Gregory, MI
Richmond - West Kingston, RI
Richmond Airport - Richmond, IN
Richmond International Airport (Byrd Field) - Richmond, VA
Richton-Perry Co - Richton, MS
Richwood Municipal - Richwood, WV
Rick Husband Amarillo International Airport - Amarillo, TX
Rickenbacker Airport - Columbus, OH
Riddick - Philipsburg, MT
Ridgefield Park - Ridgefield Park, NJ
Ridgeland - Ridgeland, SC
Ridgely - Ridgely, MD
Rigby-Jefferson Co - Rigby, ID
Ring Hill - Carmel, ME
Rinkenberger Airport - Bradford, IL
Rio Bravo - Bakersfield, CA
Rio Linda Airport - Rio Linda, CA
Rio Vista Municipal - Rio Vista, CA
Ripley - Ripley, MS
River Ranch Resort - River Ranch, FL
Riverside Flabob Airport - Riverside, CA
Riverside Heliport - Riverside, CA
Riverside Municipal Airport - Riverside, CA
Riverton Airport - Riverton, WY
Riverview - Dresden, OH
Riverview - Jenison, MI
Rives Air Park - Royse City, TX
Roanoke Municipal - Roanoke, AL
Roanoke Regional Airport - Roanoke, VA
Robbins - Oneonta, AL
Robert J. Miller Air Park - Toms River, NJ
Robert Lafleur Airport - Waterville, ME
Robert Lee - Robert Lee, TX
Robert S. Kerr Airport - Poteau, OK
Roberts Air Force Base - San Miguel, CA
Roberts Field - Redmond, OR
Robertson - Langdon, ND
Robertson - Plainville, CT
Robins Air Force Base - Macon, GA
Robinson - Vevay, IN
Robinson Aaf - Camp Robinson, AR
Robinson Municipal - Robinson, IL
Roche Harbor Airport - Roche Harbor, WA
Rochelle Mun-Koritz - Rochelle, IL
Rochester International Airport - Rochester, MN
Rochester Municipal Heliport - Rochester, MN
Rock - Tarentum, PA
Rock Co - Bassett, NE
Rock County Airport - Janesville, WI
Rock Hill Airport - Rock Hill, SC
Rock Rapids Municipal - Rock Rapids, IA
Rockford Municipal - Rockford, ID
Rockingham Co-Shiloh - Reidsville, NC
Rockingham-Hamlet - Rockingham, NC
Rockwall Municipal - Rockwall, TX
Rockwell City Municipal - Rockwell City, IA
Rockwood Municipal Airport - Rockwood, TN
Rocky Mount-Wilson Airport - Rocky Mount/Wilson, NC
Rocky Mountain Metropolitan Airport - Broomfield, CO
Rogers - Chester, CA
Rogers Airport - Rogers, AR
Rogue Valley International-Medford Airport - Medford, OR
Rohnerville - Fortuna, CA
Rolette - Rolette, ND
Rolla Downtown Airport - Rolla, MO
Rolla Municipal - Rolla, ND
Rolla National Airport - Vichy, MO
Rollang Field - Anguilla, MS
Rolle - Somerton, AZ
Roma Falcon State Airport - Roma Falcon, TX
Romeo State - Romeo, MI
Ronald Reagan National Airport - Washington, DC
Ronan - Ronan, MT
Rooke Field - Refugio, TX
Roosevelt Airport - Roosevelt, UT
Roosevelt Memorial - Warm Springs, GA
Roosterville Airport - Liberty, MO
Rosalia Municipal - Rosalia, WA
Rosamond - Rosamond, CA
Rosario Sea Plane Base - Rosario, WA
Rosaschi - Smith, NV
Roscoe Turner Airport - Corinth, MS
Roscommon Conservation - Roscommon, MI
Roscommon County Airport - Houghton Lake, MI
Roseau Municipal Airport - Roseau, MN
Roseburg Municipal Airport - Roseburg, OR
Rosecrans Memorial Airport - Saint Joseph, MO
Ross Co - Chillicothe, OH
Ross Field - Benton Harbor, MI
Ross International Airport - Sweetgrass, MT
Rosser Ranch - Graham, TX
Rossettie - Manchester, MI
Rostraver - Monongahela, PA
Rotunda Airport - Rotunda, FL
Rough River State Park - Falls Of Rough, KY
Round Lake - Round Lake, NY
Round Valley - Covelo, CA
Roundup Airport - Roundup, MT
Rountree - Hartselle, AL
Rouses Point Airport - Rouses Point, NY
Rowan Bay Airport - Rowan Bay, AK
Rowan County Airport - Salisbury, NC
Roy - Grafton, WV
Roy Hurd Memorial Airport - Monahans, TX
Royalton - Gasport, NY
Ruby Airport - Ruby, AK
Rudy'S Gliderport - High Springs, FL
Rudys - Vineland, NJ
Rugby Municipal - Rugby, ND
Ruhe'S - Leipsic, OH
Ruidoso Municipal Airport - Ruidoso, NM
Ruleville-Drew - Drew, MS
Rush City Regional - Rush City, MN
Rushford Municipal - Rushford, MN
Rusk Co - Henderson, TX
Rusk Co - Ladysmith, WI
Russell Airport - Russell, KS
Russellville Municipal - Russellville, AL
Russellville Regional - Russellville, AR
Russellville-Logan Co - Russellville, KY
Russian Mission Airport - Russian Mission, AK
Rust - Woolsey, GA
Ruston Airport - Ruston, LA
Ruth - Ruth, CA
Rutherford Co-Marchman - Rutherfordton, NC
Rutland Airport - Rutland, VT
RWJ Airpark - Baytown, TX
Ryan - Tucson, AZ
Ryan Airport - Baton Rouge, LA
Ryan Field - Hemet, CA
Ryegate - Ryegate, MT
Sac City Municipal - Sac City, IA
Sackman Field - Columbia, IL
Sacramento Executive Airport - Sacramento, CA
Sacramento International Airport - Sacramento, CA
Sacramento Mather Airport - Sacramento, CA
Safford Airport - Safford, AZ
Saginaw - Ft Worth, TX
Saginaw Bay Airport - Saginaw Bay, AK
Saginaw Co-Browne - Saginaw, MI
Saguache Municipal - Saguache, CO
Sagwon Airport - Sagwon, AK
Saint George Municipal Airport - Saint George, UT
Saint Johns Municipal Airport - Saint Johns, AZ
Saint Lucie County Airport - Fort Pierce, FL
Saint Mary's Airport - Saint Mary's, AK
Saint Marys County Airport - Leonardtown, MD
Saint Paul Island Airport - Saint Paul Island, AK
Salamon - West Union, OH
Salem - Salem, AR
Salem - Salem, OH
Salem Municipal - Salem, IN
Salida Airport - Salida, CO
Salina Airport - Salina, KS
Salina Airport - Salina, UT
Salinas Airport - Salinas, CA
Saline - Saline, MI
Saline Co/Watts - Benton, AR
Sallisaw Municipal - Sallisaw, OK
Salmon Airport - Salmon, ID
Salmon Lake - Salmon Lake, AK
Salmon River - Marlborough, CT
Salt Lake City International Airport - Salt Lake City, UT
Salt Lake City Mun No 2 - Salt Lake City, UT
Salt Lake Skypark - Bountiful, UT
Salton City Airport - Salton City, CA
Saluda Co - Saluda, SC
Salyer Farms - Corcoran, CA
Sampson County Airport - Clinton, NC
Samuels Field - Bardstown, KY
San Antonio International Airport - San Antonio, TX
San Ardo - San Ardo, CA
San Augustine Co - San Augustine, TX
San Carlos Airport - San Carlos, CA
San Carlos Apache - Globe, AZ
San Clemente I Nalf - San Clemente I, CA
San Diego International Airport - San Diego, CA
San Fernando Airport - San Fernando, CA
San Francisco International Airport - San Francisco, CA
San Geronimo - San Antonio, TX
San Jose I - Rockport, TX
San Juan County Airport - Monticello, UT
San Juan Sea Plane Base - San Juan, AK
San Luis Obispo County Regional Airport - San Luis Obispo, CA
San Manuel - San Manuel, AZ
San Marcos Municipal - San Marcos, TX
San Nicolas I Nolf - San Nicolas I, CA
San Patricio Co - Sinton, TX
San Rafael Heliport - San Rafael, CA
San Saba Co Municipal - San Saba, TX
Sand Canyon - Chewelah, WA
Sand Point Municipal Airport - Sand Point, AK
Sand Springs - Sand Springs, MT
Sanderson Field - Shelton, WA
Sandia Airpark Estates East - Edgewood, NM
Sandpoint - Sandpoint, ID
Sandstone Municipal - Sandstone, MN
Sandusky City - Sandusky, MI
Sandusky County Regional Airport - Fremont, OH
Sandy River - Sandy, OR
Sandy River Airpor - Sandy River, AK
Sanford Airport - Sanford, ME
Sanford-Lee Co Brick - Sanford, NC
Sanger - Monee, IL
Santa Ana Downtown Heliport - Santa Ana, CA
Santa Barbara Municipal Airport - Santa Barbara, CA
Santa Cruz Island Airport - Santa Barbara, CA
Santa Cruz Skypark - Santa Cruz, CA
Santa Fe Airport - Santa Fe, NM
Santa Maria Public Airport - Santa Maria, CA
Santa Monica Airport - Santa Monica, CA
Santa Paula Airport - Santa Paula, CA
Santa Rosa Municipal - Santa Rosa, NM
Santa Ynez Airport - Santa Ynez, CA
Santee Cooper Regional - Manning, SC
Santiam Junction State - Santiam Junction, OR
Saratoga Co - Saratoga Springs, NY
Sargent Municipal - Sargent, NE
Saricheff Airport - Saricheff, AK
Satanta Municipal - Satanta, KS
Saufley Naval Air Station - Pensacola, FL
Sauk Centre Municipal - Sauk Centre, MN
Sauk-Prairie - Prairie Du Sac, WI
Sault Ste Marie Municipal Airport - Sault Ste Marie, MI
Savage - Montezuma, GA
Savannah-Hardin Co - Savannah, TN
Savannah/Hilton Head Airport - Savannah, GA
Savoonga Airport - Savoonga, AK
Sawyer International Airport - Marquette, MI
Sayre Municipal - Sayre, OK
Scammon Bay Sea Plane Base - Scammon Bay, AK
Scandia - Russell, PA
Scappoose Industrial - Scappoose, OR
Schafer Usfs - Schafer, MT
Schaumburg Marriott Heliport - Schaumburg, IL
Schaumburg Regional - Chicago/Schaumburg, IL
Schenectady County Airport - Schenectady, NY
Schertz - Gibson City, IL
Schiffer Acres - St Johns, MI
Schloredt Airport - Sundance, WY
Schneiders - Revere, PA
Scholes Field - Galveston, TX
Schoolcraft County Airport - Manistique, MI
Schroeder Field - Hillsboro, KS
Schroon Lake - Schroon Lake, NY
Schuy-Rush - Rushville, IL
Schuylkill Co - Pottsville, PA
Scobey Border Stn/East Poplar* - Scobey, MT
Scotia Municipal - Scotia, NE
Scott - Mineral Wells, WV
Scott - Oroville, WA
Scott - Parsons, TN
Scott - Tallulah, LA
Scott AFB/Mid America Airport - Belleville, IL
Scott City Municipal - Scott City, KS
Scott Field - Mangum, OK
Scott Municipal - Oneida, TN
Scott Municipal - West Union, IA
Scott Valley - Ft Jones, CA
Scotts Bluff County Airport - Scottsbluff, NE
Scottsboro Mun-Word - Scottsboro, AL
Scottsburg - Scottsburg, IN
Scottsdale Municipal Airport - Phoenix, AZ
Scranton Municipal Airport - Scranton, PA
Seagraves - Seagraves, TX
Seal Bay Airport - Seal Bay, AK
Seamans - Factoryville, PA
Searchlight - Searchlight, NV
Searcy Airport - Searcy, AR
Searcy Co - Marshall, AR
Searcy Field - Stillwater, OK
Searle Field - Ogallala, NE
Seaside Municipal - Seaside, OR
Seattle-Tacoma International Airport - Seattle, WA
Sebastian Municipal - Sebastian, FL
Sebewaing - Sebewaing, MI
Sebring Air Terminal - Sebring, FL
Sedalia Airport - Sedalia, MO
Sedan City - Sedan, KS
Sedona Airport - Sedona, AZ
Seeley Lake - Seeley Lake, MT
Seiling - Seiling, OK
Sekiu - Sekiu, WA
Selawik Airport - Selawik, AK
Seldovia Airport - Seldovia, AK
Selfield Airport - Selma, AL
Selfridge Air National Guard Base - Mount Clemens, MI
Selfs Airport - Marks, MS
Seligman - Seligman, AZ
Sells - Sells, AZ
Selma - Selma, CA
Seminole Municipal - Seminole, OK
Senator Clark Airport - Gallup, NM
Seneca Aaf - Romulus, NY
Seneca Co - Tiffin, OH
Seneca Municipal - Seneca, KS
Sequim Valley Airport - Sequim, WA
Sequoia - Visalia, CA
Seven Springs - Seven Springs Borough, PA
Seward Airport - Seward, AK
Seward Municipal - Seward, NE
Seymour Johnson Air Force Base - Goldsboro, NC
Seymour Municipal - Seymour, TX
Shades State Park - Waveland, IN
Shady Acres - Spanaway, WA
Shageluk Airport - Shageluk, AK
Shaktoolik Airport - Shaktoolik, AK
Shamrock - Brooklyn, MI
Shamrock Municipal - Shamrock, TX
Shangri-la Airport - Shangri-la, OK
Shannon - Fredericksburg, VA
Sharp - Ord, NE
Sharp Co Regional - Ash Flat, AR
Sharpe Army Air Field - Lathrop, CA
Sharpe Field - Tuskegee, AL
Shaw Air Force Base - Sumter, SC
Shawano Municipal - Shawano, WI
Shawnee - Bloomfield, IN
Shawnee Municipal Airport - Shawnee, OK
Shearer Usfs - Shearer, ID
Sheboygan Memorial Airport - Sheboygan, WI
Sheep Mountain Airport - Sheep Mountain, AK
Shelby Airport - Shelby, MT
Shelby Co - Alabaster, AL
Shelby Co - Shelbyville, IL
Shelby Co - Shelbyville, MO
Shelby Community - Shelby, OH
Shelby Municipal - Shelby, NC
Shelbyville Municipal Airport - Shelbyville, IN
Sheldon Municipal - Sheldon, IA
Sheldon Sea Plane Base - Sheldon Point, AK
Shell Creek Airpark - Punta Gorda, FL
Shell Lake Municipal - Shell Lake, WI
Shelter Cove - Shelter Cove, CA
Shemya Air Force Base - Shemya, AK
Shenandoah Municipal - Shenandoah, IA
Shenandoah Valley Airport - Staunton, VA
Shenk - Garrett, IN
Sheppard Air Force Base - Wichita Falls, TX
Sheridan - Sheridan, OR
Sheridan Airport - Sheridan, IN
Sheridan Airport - Sheridan, WY
Sheridan Municipal - Sheridan, AR
Sherman Airport - Clinton, OK
Sherman Army Air Field - Fort Leavenworth, KS
Sherman Municipal - Sherman, TX
Sherman Oaks Heliport - Los Angeles, CA
Sherwood Airport - Plentywood, MT
Shiflet - Marion, NC
Shingletown - Shingletown, CA
Shiocton - Shiocton, WI
Shippensburg - Shippensburg, PA
Shiprock Airstrip - Shiprock, NM
Shirley - Shirley, MA
Shishmaref Airport - Shishmaref, AK
Shively Airport - Saratoga, WY
Shoal Cove Airport - Shoal Cove, AK
Shoshone - Shoshone, CA
Shoshone Co - Kellogg, ID
Shoshoni Municipal - Shoshoni, WY
Show Low Airport - Show Low, AZ
Shreveport Downtown Airport - Shreveport, LA
Shreveport Regional Airport - Shreveport, LA
Shungnak Airport - Shungnak, AK
Sibley - Selmer, TN
Sibley Municipal - Sibley, IA
Sidney Airport - Sidney, NE
Sidney Airport - Sidney, NY
Sidney Municipal - Sidney, OH
Sierra Sky Park - Fresno, CA
Sierraville Dearwater - Sierraville, CA
Sig Field - Montezuma, IA
Sikes - Luverne, AL
Sikeston Memorial Airport - Sikeston, MO
Sikorsky Heliport - Stratford, CT
Siler City Municipal - Siler City, NC
Siletz Bay State - Gleneden Beach, OR
Silver Bay Municipal - Silver Bay, MN
Silver City - Alpena, MI
Silver Lake F S Strip - Silver Lake, OR
Silver Springs - Silver Springs, NV
Silver West - Westcliffe, CO
Silverwood - Athol, ID
Simmons Army Airfield - Fort Bragg, NC
Simpson - Philippi, WV
Simsbury - Simsbury, CT
Sioux Center Municipal - Sioux Center, IA
Sioux Falls Regional Airport (Jo Foss Field) - Sioux Falls, SD
Sioux Gateway Airport - Sioux City, IA
Siskiyou County Airport - Montague, CA
Sisseton Municipal - Sisseton, SD
Sisters Eagle Air - Sisters, OR
Sitka Airport - Sitka, AK
Sitkinak Island Coast Guard Station - Sitkinak Island, AK
Skagit Regional Airport - Mount Vernon, WA
Skagway Municipal Airport - Skagway, AK
Skaneateles - Skaneateles, NY
Skelton - Eureka, AK
Skiatook Municipal - Skiatook, OK
Skie-Lincoln Co - Tea, SD
Skwentna Intermediate Airport - Skwentna, AK
Sky Acres - Millbrook, NY
Sky Harbor - Duluth, MN
Sky Harbor - Sultan, WA
Sky Harbor Airport - Northbrook, IL
Sky Haven - Enderlin, ND
Sky King - Terre Haute, IN
Sky Manor - Jacksonville, NC
Sky Manor - Pittstown, NJ
Sky Park - Newkirk, OK
Sky Park - Red Hook, NY
Sky Portal Airport - Montauk Point, NY
Sky Ranch - Sandy Valley, NV
Skydive Chicago - Ottawa, IL
Skydive Houston - Waller, TX
Skyharbor - Selma, AL
Skyhaven - Rochester, NH
Skyhaven - Tunkhannock, PA
Skyhaven - Warrensburg, MO
Skykomish State - Skykomish, WA
Skylane - Evansville, IN
Skylark Airpark - Warehouse Point, CT
Skyport - Cornelius, OR
Skyports Seaplane Base - New York, NY
Skyway Estates - Eaton Rapids, MI
Skyway Manor Airport - Pearland, TX
Skywest Airpark - Mobile, AL
Skywest Inc - Midland, TX
Slate Creek - Slate Creek, ID
Slater Memorial - Slater, MO
Slatington Airport - Slatington, PA
Slaton Municipal - Slaton, TX
Slayton Municipal - Slayton, MN
Sleepy Eye Municipal - Sleepy Eye, MN
Sleetmute Airport - Sleetmute, AK
Slidell - Slidell, LA
Sloulin Field International Airport - Williston, ND
Smart Airport - Macon, GA
Smiley Creek - Galena, ID
Smith - Beaufort, NC
Smith - Macomb, IL
Smith Cove Airport - Smith Cove, AK
Smith Field - Fort Wayne, IN
Smith Field - Siloam Springs, AR
Smith Memorial - Harrisonville, MO
Smith Mountain Lake - Moneta, VA
Smith Prairie - Prairie, ID
Smith-Reynolds Airport - Winston-Salem, NC
Smithville Municipal - Smithville, TX
Smithville Municipal Airport - Smithville, TN
Smoketown - Smoketown, PA
Smyrna - Smyrna, DE
Smyrna Airport - Smyrna, TN
Snohomish County Airport - Everett, WA
Snyder - Snyder, OK
Socorro Airport - Socorro, NM
Solberg-Hunterdon - Readington, NJ
Soldier Bar Usfs - Soldier Bar, ID
Soldotna Airport - Soldotna, AK
Solomon Airport - Solomon, AK
Solon Springs Municipal - Solon Springs, WI
Somerset - Somerville, NJ
Somerset Co - Somerset, PA
Somerville - Ada, MI
Sonoma County Airport - Santa Rosa, CA
Sonoma Skypark - Sonoma, CA
Sonoma Valley Airport - Schellville-Sonoma, CA
Sonora Municipal - Sonora, TX
South Albany - South Bethlehem, NY
South Bend Regional - South Bend, IN
South Big Horn County Airport - Greybull, WY
South Co Of Santa Clara Co - San Martin, CA
South Fulton - Palmetto, GA
South Haven Area Regional - South Haven, MI
South Lafourche - Galliano, LA
South Lake Tahoe Airport - South Lake Tahoe, CA
South Lakeland Airport - Mulberry, FL
South Naknek Airport - South Naknek, AK
South Padre Island International Airport - Brownsville, TX
South St Paul Municipal Airport - South St Paul, MN
South Texas Regional Airport at Hondo - Hondo, TX
South Weymouth Airport - South Weymouth, MA
Southard - Bieber, CA
Southbridge Municipal - Southbridge, MA
Southeast Greensboro - Greensboro, NC
Souther - Americus, GA
Southern California Logistics Airport - Victorville, CA
Southern Cross - Williamstown, NJ
Southern Illinois Airport - Carbondale, IL
Southern Sea Plane Base - Belle Chasse, LA
Southland - Sulphur, LA
Southwest Florida International Airport - Fort Myers, FL
Space Center Executive Airport - Titusville, FL
Spaceland Airport - Houston, TX
Spadaro - East Moriches, NY
Spanaway - Spanaway, WA
Spanish Fork-Springville - Spanish Fork, UT
Spanish Peaks - Walsenburg, CO
Spanish Springs - Reno, NV
Sparrevohn Air Force Station - Sparrevohn, AK
Sparta - Sparta, MI
Sparta Community Airport - Sparta, IL
Spartanburg Downtown Memorial Airport - Spartanburg, SC
Spaulding - Susanville, CA
Spearman Municipal - Spearman, TX
Speedway Airport - Indianapolis, IN
Spence Airport - Moultrie, GA
Spencer - Spencer, MA
Spencer Municipal Airport - Spencer, IA
Spencerport - Spencerport, NY
Spicewood - Spicewood, TX
Spirit Lake Airport - Spirit Lake, IA
Spirit of St. Louis Airport - Saint Louis, MO
Splane Memorial Airport - Oil City, PA
Spokane International Airport - Spokane, WA
Sportsman - Newberg, OR
Spotted Bear Usfs - Spotted Bear, MT
Spring Hill - Sterling, PA
Springdale Municipal Airport - Springdale, AR
Springer Municipal - Springer, NM
Springerville Babbitt - Springerville, AZ
Springfield Airport - Springfield, OH
Springfield Municipal - Springfield, CO
Springfield Municipal - Springfield, MN
Springfield Municipal - Springfield, SD
Springfield Robertson Co - Springfield, TN
Springfield-Branson Regional Airport - Springfield, MO
Springhill - Springhill, LA
Springview Municipal - Springview, NE
Spruce Creek - Daytona Beach, FL
St Charles Airport - St Charles, MO
St Clair County International Airport - Port Huron, MI
St Elmo - St Elmo, AL
St George - St George, AK
St George - St George, SC
St George Island - Apalachicola, FL
St Helen - St Helen, MI
St Ignatius - St Ignatius, MT
St James Municipal - St James, MN
St John The Baptist Parish - Reserve, LA
St Labre Mission - Ashland, MT
St Landry Parish Airport - Opelousas, LA
St Louis Metro East Shafer Field  - St Jacob, IL
St Maries Municipal - St Maries, ID
St Marys - St Marys, GA
St Marys Airport - Saint Marys, MD
St Thomas Municipal - St Thomas, ND
St. Augustine Airport - Saint Augustine, FL
St. Clair County Airport - Pell City, AL
St. Cloud Municipal Airport - Saint Cloud, MN
St. Cloud Municipal Heliport - Saint Cloud, MN
St. George Island Airport - Saint George Island, AK
St. Louis Downtown Airport - Saint Louis, MO
St. Louis Regional Airport - Alton, IL
St. Marys Airport - Sainte Marys, PA
St. Michael - St. Michael, AK
St. Michael Airport - Saint Michael, AK
St. Paul Downtown Airport - Saint Paul, MN
St. Petersburg-Clearwater International Airport - Saint Petersburg, FL
Stafford - Weatherford, OK
Stafford Municipal - Stafford, KS
Stafford Regional Airport - Stafford, VA
Stahl'S Mountain - Union Dale, PA
Stallings Field - Kinston, NC
Stambaugh - Stambaugh, MI
Stampede - Kantishna, AK
Standard - Elkton, KY
Standing Rock - Ft Yates, ND
Standish Industrial - Standish, MI
Stanford - St Anthony, ID
Stanford - Stanford, MT
Stanley - Stanley, ID
Stanley Municipal - Stanley, ND
Stanly Co - Albemarle, NC
Stanton - New Paltz, NY
Stanton - Stanton, KY
Stanton Co Municipal - Johnson, KS
Stanton Municipal - Stanton, TX
Staples Municipal - Staples, MN
Star City Municipal - Star City, AR
Starbuck Municipal - Starbuck, MN
Stark'S Twin Oaks - Hillsboro, OR
Starke Co - Knox, IN
Starr Co - Rio Grande City, TX
Starr-Browning - Browning, MT
State Airport - Bandon, OR
State Airport - Chiloquin, OR
State Airport - Easton, WA
State Airport - Gold Beach, OR
State Airport - Hermiston, OR
State Airport - Newport, RI
State Airport - Pacific City, OR
State Airport - Rome, OR
State Airport - Scribner, NE
State Airport - Springfield, VT
Statesboro Municipal Airport - Statesboro, GA
Statesville Municipal Airport - Statesville, NC
Steamboat Sea Plane Base - Steamboat Bay, AK
Steamboat Springs Airport - Steamboat Springs, CO
Stebbins Airport - Stebbins, AK
Steel Pier Heliport - Atlantic City, NJ
Steele Municipal - Steele, MO
Stefan Field - Norfolk, NE
Stehekin State - Stehekin, WA
Stellar Air Park - Chandler, AZ
Stennis International Airport - Bay St. Louis, MS
Stephen Municipal - Stephen, MN
Stephens County Airport - Breckenridge, TX
Stephens-Gilmer Municipal - Gilmer, TX
Sterling - Sterling, MA
Stevens Crosby - North Fork, NV
Stevens Field - Pagosa Springs, CO
Stevens Point Airport - Stevens Point, WI
Stevens Village Airport - Stevens Village, AK
Stevenson - Stevenson, AL
Stevensville - Stevensville, MT
Stewart - Waynesville, OH
Stewart Airport - Newburgh, NY
Stigler Municipal - Stigler, OK
Stilwell/Cherokee Nation - Stilwell, OK
Stinson - Aberdeen, MS
Stinson Municipal Airport - San Antonio, TX
Stockmar - Villa Rica, GA
Stockton Airport - Stockton, CA
Stockton Municipal - Stockton, KS
Stockton Municipal - Stockton, MO
Stolport Airport - Vallejo, CA
Stoltzfus Airfield - Kidron, OH
Stonewall Co - Aspermont, TX
Stonington Municipal - Stonington, ME
Stony River Airport - Stony River, AK
Storm Lake Municipal Airport - Storm Lake, IA
Stormville - Stormville, NY
Stove Pipe Wells - Death Valley Natl Park, CA
Stratford - Stratford, TX
Strom - Morton, WA
Stromsburg Municipal - Stromsburg, NE
Stroud Airport - Stroud, OK
Stuart Island Airport - Stuart Island, WA
Stuart-Atkinson Municipal - Atkinson, NE
Sturgis Municipal - Sturgis, KY
Sturgis Municipal - Sturgis, SD
Stuttgart Airport - Stuttgart, AR
Suburban - Laurel, MD
Sudden Stop - Collinsville, TX
Suffolk County Airport - Westhampton, NY
Suffolk Municipal - Suffolk, VA
Sugar Land Municipal Airport - Houston, TX
Sugar Loaf Resort - Traverse City, MI
Sugar Valley - Mocksville, NC
Sugarloaf Regional - Carrabassett, ME
Sullivan County Airport - Sullivan, IN
Sullivan County International Airport - Monticello, NY
Sullivan Lake State - Metaline Falls, WA
Sullivan Regional - Sullivan, MO
Sully Municipal - Sully, IA
Sulphur Municipal - Sulphur, OK
Sulphur Springs Airport - Sulphur Springs, TX
Summersville - Summersville, WV
Summerville - Summerville, SC
Summit - Middletown, DE
Summit Airport - Summit, AK
Sumner County Regional Airport - Gallatin, TN
Sumter Municipal Airport - Sumter, SC
Sun Hill Ranch - Helendale, CA
Sun River Airport - Sun River, OR
Sun Valley - Bullhead City, AZ
Sun Valley Airport - Sun Valley, ID
Sunburst - Sunburst, MT
Sunbury - Sunbury, PA
Sundance - Oklahoma City, OK
Sunnyside Municipal - Sunnyside, WA
Sunray - Sunray, TX
Sunrise Beach - Sunrise Beach Village, TX
Sunset Skyranch - Elk Grove, CA
Superior Municipal - Superior, AZ
Superior Municipal - Superior, NE
Susanville Airport - Susanville, CA
Sussex - Sussex, NJ
Sussex County Airport - Georgetown, DE
Sutter Co - Yuba City, CA
Suwannee Co - Live Oak, FL
Swan Creek - Jonesville, NC
Swans - Dixfield, ME
Swanson - Eatonville, WA
Sweetwater Airport - Sweetwater, TX
Sweetwater County Airport - Rock Springs, WY
Sycamore Strip - Ft Worth, TX
Sylvania - Sturtevant, WI
Sylvester Airport - Sylvester, GA
Syracuse-Hamilton Co Municipal - Syracuse, KS
T-Bar - Tahoka, TX
Tabneta Pass Airport - Tabneta Pass Lodge, AK
Tackaberry - Avoca, MI
Taft-Kern Co - Taft, CA
Tahlequah Municipal - Tahlequah, OK
Takotna Airport - Takotna, AK
Taku Sea Plane Base - Taku Lodge, AK
Talihina Municipal - Talihina, OK
Talkeetna Airport - Talkeetna, AK
Talladega Airport - Talladega, AL
Tallahassee Commercial - Tallahassee/Havana, FL
Tallahassee Regional Airport - Tallahassee, FL
Tamiami Airport - Miami, FL
Tampa Bay Executive Airport - New Port Richey, FL
Tampa Executive Airport - Tampa, FL
Tampa International Airport - Tampa, FL
Tanacross Intermediate Airport - Tanacross, AK
Tanalian Point Airport - Tanalian Point, AK
Tangier I - Tangier, VA
Tanner-Hiller - Barre, MA
Taos Airport - Taos, NM
Tappahannock Municipal - Tappahannock, VA
Tarboro-Edgecombe - Tarboro, NC
Tarrant - Mt Selman, TX
Tatalina Air Force Station - Tatalina, AK
Tatitlek Airport - Tatitlek, AK
Taunton Municipal - Taunton, MA
Taylor - Albany, TX
Taylor - Quinlan, TX
Taylor Airport - Taylor, AK
Taylor Airport - Taylor, AZ
Taylor Co - Campbellsville, KY
Taylor Field - Ocala, FL
Taylor Municipal - Taylor, TX
Taylorville Municipal - Taylorville, IL
Tazewell Co - Richlands, VA
Tazlina - Tazlina, AK
Teague Municipal - Teague, TX
Technology Park Heliport - Atlanta, GA
Tecumseh Municipal - Tecumseh, NE
Ted Stevens Anchorage International Airport - Anchorage, AK
Tekamah - Tekamah, NE
Telfair-Wheeler Airport - McRae, GA
Telida Airport - Telida, AK
Teller Airport - Teller, AK
Telluride Airport - Telluride, CO
Temple Bar - Temple Bar, AZ
Tenakee Springs Sea Plane Base - Tenakee Springs, AK
Tenkiller Lake Airpark - Cookson, OK
Tensas Parish - St Joseph, LA
Teramiranda - Afton, OK
Terlingua Ranch - Alpine, TX
Tern I. - Tern I., HI
Terrebonne Airport - Houma, LA
Terrell Co - Dryden, TX
Terrell Field - Terrell, TX
Terry - Terry, MT
Terry Co - Brownfield, TX
Teterboro Airport - Teterboro, NJ
Tetlin Airport - Tetlin, AK
Texarkana Municipal Airport - Texarkana, AR
Texas Park Ten Heliport - Houston, TX
Thackers - Oil City, LA
Thayer Memorial - Thayer, MO
The Albertville Mun-Brumlik - Albertville, AL
The City Heliport - Orange, CA
The Dalles Airport - The Dalles, OR
The Red River - Coushatta, LA
The Sigurd Anderson - Webster, SD
Theodore Francis Green Memorial State Airport - Providence, RI
Thibodaux Municipal - Thibodaux, LA
Thief River Falls Regional Airport - Thief River Falls, MN
Thielen - Dorrance, KS
Thigpen - Bay Springs, MS
Thomas C Russell Field - Alexander City, AL
Thomas Co - Thedford, NE
Thomas Creek - Stanley, ID
Thomas Memorial - Glendo, WY
Thomas Municipal - Thomas, OK
Thomaston-Upson Co - Thomaston, GA
Thomasville Airport - Moultrie, GA
Thomasville Regional Airport - Thomasville, GA
Thompson Falls - Thompson Falls, MT
Thompson-Robbins Airport - Helena, AR
Thompsonfield Airport - Thompsonfield, MO
Thompsonville - Thompsonville, MI
Thomson-Mc Duffie Co - Thomson, GA
Thorne Bay Airport - Thorne Bay, AK
Thornton - Brownsville, TN
Thousand Oaks Heliport - Thousand Oaks, CA
Three Castles - Wonewoc, WI
Three Forks - Three Forks, MT
Three Lakes Municipal - Three Lakes, WI
Throckmorton Municipal - Throckmorton, TX
Tiber Dam - Tiber Dam, MT
Ticonderoga Municipal - Ticonderoga, NY
Tieton State - Rimrock, WA
Tiger - Fernley, NV
Tigert - Soda Springs, ID
Tikchik Sea Plane Base - Tikchik, AK
Tillamook - Tillamook, OR
Tillitt - Forsyth, MT
Timber Lake Municipal - Timber Lake, SD
Tin City Air Force Station - Tin City, AK
Tin Creek - Farewell Lake, AK
Tinker Air Force Base - Oklahoma City, OK
Tioga Municipal Airport - Tioga, ND
Tipton Airport - Fort Meade, MD
Tipton Municipal - Tipton, OK
Tishomingo - Tishomingo, OK
Tishomingo Co - Belmont, MS
Titus - Arthurdale, WV
Titusville - Titusville, PA
Toccoa Airport - Toccoa, GA
Todd - Long Prairie, MN
Todd Field - Ankeny, IA
Togiak Fishery Airport - Togiak Fishery, AK
Togiak Village Airport - Togiak Village, AK
Tok Airport - Tok, AK
Tok Junction - Tok, AK
Tokeen Airport - Tokeen, AK
Toketee State - Clearwater, OR
Toksook Bay Airport - Toksook Bay, AK
Toledo Executive Airport - Toledo, OH
Toledo Municipal - Toledo, IA
Toledo State - Toledo, OR
Toledo Suburban - Lambertville, MI
Tom O'Connor Oil Field Airport - Refugio, TX
Tomahawk Regional - Tomahawk, WI
Tombstone Municipal - Tombstone, AZ
Tomlinson - New Rockford, ND
Tompkins County Airport - Ithaca, NY
Tompkinsville-Monroe Co - Tompkinsville, KY
Tonasket Municipal - Tonasket, WA
Tonopah Airport - Tonopah, NV
Tonopah Test Range Airport - Tonopah, NV
Topp of Tampa Airport - Tampa, FL
Torchport - Eastport, MI
Torrington Municipal Airport - Torrington, WY
Toutant - Putnam, CT
Tower Municipal - Tower, MN
Town And Country - Lubbock, TX
Towner Municipal - Towner, ND
Townsend - Townsend, MT
Tracy Municipal - Tracy, CA
Tracy Municipal - Tracy, MN
Tradewater - Dawson Springs, KY
Tradewind Airport - Amarillo, TX
Traer Municipal - Traer, IA
Transco Tower Galleria Heliport - Houston, TX
Traverse City Airport - Traverse City, MI
Travis Air Force Base - Fairfield, CA
Trego Wakeeney - Wakeeney, KS
Tremonton Airport - Tremonton, UT
Trenton Memorial Airport - Trenton, MO
Trenton Municipal - Trenton, NE
Trenton-Mercer Airport - Trenton, NJ
Trenton-Robbinsville - Robbinsville, NJ
Treutlen Co - Soperton, GA
Tri City Airport - Saginaw, MI
Tri Co - Ahoskie, NC
Tri Co - Bonifay, FL
Tri County - Yates, IL
Tri County Regional Airport - Lone Rock, WI
Tri-Cities - Endicott, NY
Tri-Cities Airport - Pasco, WA
Tri-Cities Regional - Bristol, VA/Johnson City/Kingsport, TN
Tri-City - Sebring, OH
Tri-City - West Lafayette, OH
Tri-City Airport - Parsons, KS
Tri-City Airport - San Bernardino, CA
Tri-County - Erie, CO
Tri-State Steuben County Airport - Angola, IN
Tri-State/Milton Airport - Huntington, WV
Tri-Township - Savanna, IL
Triangle North Executive Airport - Louisburg, NC
Tribune Municipal - Tribune, KS
Trinca - Andover, NJ
Trinity Center - Trinity Center, CA
Trinity Co - Groveton, TX
Triple H - Parchment, MI
Triple W Airport - Raleigh, NC
Tripp Creek - St Johns, MI
Trona Airport - Trona, CA
Troutdale Airport - Troutdale, OR
Troy - Troy, MT
Troy - Troy, OH
Troy Municipal Airport - Troy, AL
Truckee Airport - Truckee, CA
Trulson - Plaza, ND
Truth Or Consequences Municipal Airport - Truth Or Consequences, NM
TSTC Waco Airport - Waco, TX
Tuba City Airport - Tuba City, AZ
Tuck - South Boston, VA
Tucker-Guthrie Memorial - Harlan, KY
Tucson International Airport - Tucson, AZ
Tucumcari Airport - Tucumcari, NM
Tulare Airport - Tulare, CA
Tulelake Municipal - Tulelake, CA
Tulsa International Airport - Tulsa, OK
Tulsa Security - Tulsa, OK
Tuluksak Airport - Tuluksak, AK
Tunica - Tunica, MS
Tunica Municipal Airport - Tunica, MS
Tuntutuliak Airport - Tuntutuliak, AK
Tununak Airport - Tununak, AK
Turlock Municipal - Turlock, CA
Turner - Turner, MT
Turner Co - Ashburn, GA
Turners Falls - Montague, MA
Turtle Lake Municipal - Turtle Lake, ND
Tuscaloosa Regional Airport - Tuscaloosa, AL
Tuweep - Tuweep, AZ
Twentynine Palms Airport - Twentynine Palms, CA
Twin Bridges - Twin Bridges, MT
Twin Bridges Emergency - Ketchum, ID
Twin City - Loris, SC
Twin City - Marble Hill, MO
Twin Co - Galax-Hillsville, VA
Twin Falls City County Airport - Twin Falls, ID
Twin Hills Airport - Twin Hills, AK
Twin Lakes - Graniteville, SC
Twin Lakes - Mocksville, NC
Twin Mountain - Twin Mountain, NH
Twin Oaks - San Antonio, TX
Twin Pine - Pennington, NJ
Twisp Municipal - Twisp, WA
Twitchell - Turner, ME
Two Harbors Airport - Catalina Island, CA
Tyler Co - Woodville, TX
Tyler Municipal - Tyler, MN
Tyndall Air Force Base - Panama City, FL
Tyonek Airport - Tyonek, AK
Uganik Airport - Uganik, AK
Ugashik Airport - Ugashik, AK
Ugashik Bay Airport - Pilot Point, AK
Ugnu Kuparuk - Ugnu Kuparuk, AK
Ukiah Airport - Ukiah, CA
Ulysses - Ulysses, KS
Umatilla Municipal - Umatilla, FL
Umiat Airport - Umiat, AK
Umnak Island Airport - Umnak Island, AK
Unalakleet Airport - Unalakleet, AK
Union Co - Columbus, OH
Union Co-Shelton - Union, SC
Union Municipal - Union, MS
Union Station Heliport - Los Angeles, CA
United States Air Force Academy Airport - Colorado Springs, CO
United States Army Heliport - Arlington Heights, IL
United States Naval Heliport - Anacostia, DC
Universal City Heliport - Los Angeles, CA
University - Bath, MI
University Airport - Davis, CA
University Park - State College, PA
University Park Airport - State College, PA
University-Oxford Airport - Oxford, MS
Upolu Point Airport - Upolu Point, HI
Upper Bucks Airport - Quakertown, PA
Upper Cumberland Regional Airport - Sparta, TN
Upper Loon Creek Usfs - Challis, ID
Upshur Co - Buckhannon, WV
Upton Co - Mc Camey, TX
Upton Municipal - Upton, WY
Us Heliport - Wingate, NC
Ute Dam - Logan, NM
Vaiden - Marion, AL
Valdez Municipal Airport - Valdez, AK
Valdosta Regional Airport - Valdosta, GA
Valhalla - North Cape, WI
Valier - Valier, MT
Valkaria - Valkaria, FL
Valle - Grand Canyon, AZ
Valley International Airport - Harlingen, TX
Valley Mills Municipal - Valley Mills, TX
Valley View - Estacada, OR
Van Nuys Airport - Los Angeles, CA
Van Wagnen Airport - Napoleon, MI
Van Wert Co - Van Wert, OH
Van-Pak - Prairie View, KS
Vance Air Force Base - Enid, OK
Vandalia Airport - Vandalia, IL
Vandenburg Air Force Base - Lompoc, CA
Vansant - Erwinna, PA
Vashon Municipal - Vashon, WA
Vaughn Spraying - Kress, TX
Venetie Airport - Venetie, AK
Venice Municipal Airport - Venice, FL
Vermilion Regional Airport - Danville, IL
Vernal Airport - Vernal, UT
Vernonia - Vernonia, OR
Vero Beach Municipal Airport - Vero Beach, FL
Verona - Verona, WI
Versailles Airport - Versailles, MO
Vici Municipal - Vici, OK
Vicksburg Airport - Vicksburg, MS
Vicksburg Tallulah Regional - Tallulah/Vicksburg, LA
Vidalia Municipal Airport - Vidalia, GA
Viertel Memorial - Boonville, MO
View Cove Airport - View Cove, AK
Village Sea Plane Base - West Point, AK
Vincent - Genoa City, WI
Vineland Downstown - Vineland, NJ
Vinita Municipal - Vinita, OK
Vinton Co - Mc Arthur, OH
Vinton-Veterans Memorial - Vinton, IA
Virgil I Grissom Municipal Airport - Bedford, IN
Virginia Highlands Airport - Abingdon, VA
Virginia Tech Airport - Blacksburg, VA
Viroqua Municipal - Viroqua, WI
Visalia Airport - Visalia, CA
Vista - Kennewick, WA
Vivian - Vivian, LA
Volk Field - Camp Douglas, WI
Vor Airport - Otto, NM
W T Piper Memorial Airport - Lock Haven, PA
Wabash Municipal - Wabash, IN
Waco Municipal Airport - Waco, TX
Wadena Municipal - Wadena, MN
Wadsworth Municipal Airport - Wadsworth, OH
Wagner Municipal - Wagner, SD
Wagoner Municipal - Wagoner, OK
Wahoo Municipal Airport - Wahoo, NE
Wahpeton Airport - Wahpeton, ND
Waikoloa Airport - Waikoloa, HI
Wainwright Aaf - Ft Wainwright, AK
Wainwright Airport - Wainwright, AK
Wakefield Municipal - Wakefield, VA
Wakeman Airport - Wakeman, OH
Wakonda Beach State - Waldport, OR
Wakulla Co - Panacea, FL
Walden-Jackson Co - Walden, CO
Waldron Island Airport - Waldron Island, WA
Waldron Municipal - Waldron, AR
Wales - Wales, ME
Wales Airport - Wales, AK
Walhalla Municipal - Walhalla, ND
Walker Co-Bevill - Jasper, AL
Walker Municipal - Walker, MN
Walker-Waterloo - Waterloo, IN
Wall Lake Municipal - Wall Lake, IA
Wall Municipal - Wall, SD
Wall St (Heliport) - New York, NY
Walla Walla Airport - Walla Walla, WA
Wallace Municipal - Wallace, NE
Walle - Pullman, MI
Wallops Flight Facility - Chincoteague, VA
Walnut Ridge Airport - Walnut Ridge, AR
Walt Disney World Airport - Orlando, FL
Walterboro Municipal Airport - Walterboro, SC
Walters Municipal - Walters, OK
Waltham Airport - Waltham, MA
Wamego Municipal - Wamego, KS
Ward - Beasley, TX
Ward - Gasquet, CA
Ware Airport - Ware, MA
Ware County Airport - Waycross, GA
Warf - Reidsville, NC
Warm Spring Bay Sea Plane Base - Baranof, AK
Warm Springs Creek - Lowman, ID
Warminster Nawc - Warminster, PA
Warner Center Business Plaza Heliport - Los Angeles, CA
Warner Robins - Warner Robins, GA
Warren - Warren, OH
Warren Air Force Base - Cheyenne, WY
Warren County Airport - Bowling Green, KY
Warren County Airport - Front Royal, VA
Warren County Airport - Glens Falls, NY
Warren County Memorial Airport - McMinnville, TN
Warren Field - Washington, NC
Warren Municipal - Warren, AR
Warren Municipal - Warren, MN
Warren Usfs - Warren, ID
Warren-Sugarbush - Warren, VT
Warrenton-Fauquier - Warrenton, VA
Warroad Airport - Warroad, MN
Warsaw Municipal - Warsaw, IN
Warsaw Municipal - Warsaw, MO
Warwick Municipal - Warwick, NY
Wasco State - Wasco, OR
Wasco-Kern Co - Wasco, CA
Waseca Municipal - Waseca, MN
Wash. County Regional Airport - Hagerstown, MD
Washburn Municipal - Washburn, ND
Washington Co - Potosi, MO
Washington County Airport - Akron, CO
Washington Dulles International Airport - Washington, DC
Washington Executive/Hyde - Clinton, MD
Washington I - Washington I, WI
Washington Memorial Airport - Washington, MO
Washington Municipal - Washington, IA
Washington-Wilkes Co - Washington, GA
Wasilla Airport - Wasilla, AK
Waskish Municipal - Waskish, MN
Water Valley Municipal - Water Valley, MS
Waterbury - Waterbury, CT
Waterbury-Oxford Airport - Oxford, CT
Waterfall Sea Plane Base - Waterfall, AK
Waterfront Sea Plane Base - Ketchikan, AK
Waterloo Airport - Waterloo, IA
Watertown Airport - Watertown, NY
Watertown Airport - Watertown, SD
Watertown Municipal - Watertown, WI
Waterville - Waterville, WA
Watervliet - Watervliet, MI
Watford City Municipal - Watford City, ND
Watonga - Watonga, OK
Watsonville Airport - Watsonville, CA
Watts Woodland Airport - Woodland, CA
Wauchula Municipal Airport - Wauchula, FL
Waukegan Memorial Airport - Waukegan, IL
Waukesha Airport - Waukesha, WI
Waukon Municipal Airport - Waukon, IA
Waunakee - Waunakee, WI
Waupaca Municipal - Waupaca, WI
Wausau Municipal Airport - Wausau, WI
Wautoma Municipal - Wautoma, WI
Waverly Municipal - Waverly, IA
Wayne Co - Monticello, KY
Wayne County Airport - Wooster, OH
Wayne Municipal - Wayne, NE
Wayne Wonderland - Loa, UT
Waynesboro Municipal - Waynesboro, MS
Waynoka Municipal - Waynoka, OK
Weatherby Usfs - Atlanta, ID
Webb Air Force Base - Big Spring, TX
Webster City Municipal Airport - Webster City, IA
Webster Olf - St Inigoes, MD
Weed - Weed, CA
Weedon Field - Eufaula, AL
Weide Army Air Field - Edgewood Arsenal, MD
Weiker Airport - Green Springs, OH
Weiser - Houston, TX
Weiser Municipal - Weiser, ID
Welch Municipal - Welch, WV
Weld County Airport - Greeley, CO
Welke - Beaver I, MI
Weller - Urbana, OH
Wellington Municipal - Wellington, KS
Wells - Rockford, MI
Wells Jr - Columbus, TX
Wells Municipal - Wells, MN
Wells Seaplane Base - Schenectady, NY
Wellsville Municipal Airport - Wellsville, NY
Welsh - Welsh, LA
Weltzien Skypark Airport - Wadsworth, OH
Wend Valley - Charlotte, MI
Wendover Airport - Wendover, UT
West 30th Street Heliport - New York, NY
West Bend Airport - West Bend, WI
West Branch Community - West Branch, MI
West Chase Hilton Heliport - Houston, TX
West Fargo Utility - Fargo, ND
West Fork Lodge - Conner, MT
West Georgia Regional-Gray - Carrollton, GA
West Houston Airport - Houston, TX
West Kavik Airport - West Kavik, AK
West Kentucky - Paducah, KY
West Kuparuk Airport - West Kuparuk, AK
West Liberty - West Liberty, KY
West Memphis Municipal Airport - West Memphis, AR
West Michigan Regional Airport - Holland, MI
West Palm Beach International Airport - West Palm Beach, FL
West Plains Municipal - West Plains, MO
West Texas - El Paso, TX
West Woodward Airport - Woodward, OK
Westchester County Airport - Westchester County, NY
Westerly State Airport - Westerly, RI
Western - Yelm, WA
Westfield Airport - Westfield, IN
Westfield-Barnes Regional Airport - Westfield, MA
Westheimer - Houston, TX
Westhope Municipal - Westhope, ND
Westmoreland County Airport - Latrobe, PA
Westosha - Wilmot, WI
Westover Metropolitan Airport - Springfield, MA
Westover-Amador Co - Jackson, CA
Westport - Westport, NY
Westport - Westport, WA
Westport - Wichita, KS
Westsound Airport - Westsound, WA
Wetumpka Municipal - Wetumpka, AL
Wexford County Airport - Cadillac, MI
Weydahl - Killdeer, ND
Whale Pass Airport - Whale Pass, AK
Wharton Airport - Wharton, TX
Wheatland Co - Harlowton, MT
Wheaton Municipal - Wheaton, MN
Wheeler - Knox, IN
Wheeler Air Force Base - Wahiawa, HI
Wheeler Municipal - Wheeler, TX
Wheeler-Sack Aaf - Ft Drum, NY
Whetstone International - Port Of Del Bonita, MT
Whidbey - Langley, WA
Whiskey Creek - Silver City, NM
White - Zellwood, FL
White Birch - Hancock, NY
White Cloud - White Cloud, MI
White Co - Monticello, IN
White Mountain Airport - White Mountain, AK
White River Airport - White River, AZ
White River Municipal - White River, SD
White Sulphur Springs - White Sulphur Springs, MT
Whitefield Regional Airport - Whitefield, NH
Whitefish - Whitefish, MT
Whitehouse Nolf - Jacksonville, FL
Whitehurst - Bolivar, TN
Whiteman Air Force Base - Warrensburg, MO
Whiteman Airport - Los Angeles, CA
Whitesburg Municipal Airport - Whitesburg, KY
Whiteside County Airport - Sterling, IL
Whitfield Farms - Hurdle Mills, NC
Whitford'S - Weedsport, NY
Whiting Field Naval Air Station - Milton, FL
Whiting Fld Nas (North) - Milton, FL
Whiting Memorial - Mapleton, IA
Whitman - Manassas, VA
Whitman Co Memorial - Colfax, WA
Whitted Airport - Saint Petersburg, FL
Whittier - Whittier, AK
Wichita Valley - Wichita Falls, TX
Wickenburg Municipal - Wickenburg, AZ
Wickenheiser - Carleton, MI
Wicomico County Airport - Salisbury-Ocean City, MD
Wilbarger Co - Vernon, TX
Wilber Municipal - Wilber, NE
Wilbur - Wilbur, WA
Wilburton Municipal - Wilburton, OK
Wilcox - Anthony, KS
Wilcox - Chatom, AL
Wild Rose Idlewild - Wild Rose, WI
Wilder - De Smet, SD
Wilderness Airpark - Kent City, MI
Wildman Lake Airport - Wildman Lake, AK
Wiley - Winner, SD
Wiley Ford Airport - Cumberland, MD
Wiley Post Airport - Oklahoma City, OK
Wiley Post Will Rogers Memorial Airport - Barrow, AK
Wilgrove Air Park - Charlotte, NC
Wilhelmi - Joliet, IL
Wilkes County Airport - Wilkesboro, NC
Wilkes-Barre International Airport - Wilkes-Barre, PA
Will Rogers World Airport - Oklahoma City, OK
Willapa Harbor - South Bend-Raymond, WA
Willard - Tekoa, WA
Willard - Willard, OH
Willard University Airport - Champaign, IL
William J Fox Airport - Lancaster, CA
William P. Hobby Airport - Houston, TX
Williams - Porter, TX
Williams - Raymond, MS
Williams Co - Bryan, OH
Williams Memorial - Davison, MI
Williams Memorial - Midvale, ID
Williams Ranch - Caddo Gap, AR
Williamsburg Co - Kingstree, SC
Williamsburg-Cumberland Falls - Williamsburg, KY
Williamsburg-Jamestown - Williamsburg, VA
Williamson County Airport - Marion, IL
Williamson-Sodus - Williamson-Sodus, NY
Williston Municipal - Williston, FL
Willmar Airport - Willmar, MN
Willow Airport - Willow, AK
Willow Grove Naval Air Station - Willow Grove, PA
Willow Run Airport - Detroit, MI
Willow Springs Memorial - Willow Springs, MO
Wills Point Municipal - Wills Point, TX
Wilmington International Airport - Wilmington, NC
Wilroads Gardens - Dodge City, KS
Wilsall - Wilsall, MT
Wilson - Pocahontas, AR
Wilson - Stephens, AR
Wilson Creek - Wilson Creek, WA
Wilson Industrial Air Center - Wilson, NC
Wilson'S - Hickory, NC
Winchester Municipal - Winchester, TN
Winchester Regional Airport - Winchester, VA
Winder Airport - Winder, GA
Windham - Willimantic, CT
Windle Municipal - Greensburg, KS
Windom Municipal Airport - Windom, MN
Window Rock - Window Rock, AZ
Wings - Philadelphia, PA
Wings Field - Blue Bell, PA
Wings For Christ International Fl Acad* - Waco, TX
Winifred - Winifred, MT
Wink Airport - Wink, TX
Winlock Airport - Toledo, WA
Winnemucca Airport - Winnemucca, NV
Winnsboro Municipal - Winnsboro, LA
Winnsboro Municipal - Winnsboro, TX
Winona Municipal Airport - Winona, MN
Winona-Montgomery Co - Winona, MS
Winslow Airport - Winslow, AZ
Winsted Municipal - Winsted, MN
Winston County Airport - Louisville, MS
Winston Field - Snyder, TX
Winters Municipal - Winters, TX
Winterset-Madison Co - Winterset, IA
Wiscasset Airport - Wiscasset, ME
Wisdom - Wisdom, MT
Wise Airport - Wise, VA
Wise River - Wise River, MT
Wiseman Airport - Wiseman, AK
Wishek Municipal - Wishek, ND
Witham Field - Stuart, FL
Wittman Field - Oshkosh, WI
WK Kellogg Regional Airport - Battle Creek, MI
Wofford - Weiner, AR
Wolf Point International Airport - Wolf Point, MT
Wolf River - Rossville, TN
Wolfe Air Park - Manvel, TX
Wood Co - Bowling Green, OH
Wood Co - Mineola/Quitman, TX
Wood County Airport - Parkersburg, WV
Wood River Airport - Wood River, AK
Woodbine Municipal - Woodbine, IA
Woodbine Municipal - Woodbine, NJ
Woodchopper Airport - Woodchopper, AK
Woodlake - Woodlake, CA
Woodland State - Woodland, WA
Woodlawns Heliport - Houston, TX
Woodruff Co - Augusta, AR
Woodruff Lake - Winn, MI
Woodward Field - Camden, SC
Woodworth - Woodworth, LA
Woolsey Memorial - Northport, MI
Worcester Regional Airport - Worcester, MA
Worland Airport - Worland, WY
World Trade Center Airport - New York, NY
Worthington Airport - Worthington, MN
Wrangell Airport - Wrangell, AK
Wray Municipal - Wray, CO
Wrench Creek Airport - Wrench Creek, AK
Wrens Memorial - Wrens, GA
Wright Air Force Base - Dayton, OH
Wright Army Air Field - Hinesville, GA
Wurtsboro-Sullivan Co - Wurtsboro, NY
Wurtsmith Air Force Base - Oscoda, MI
Wyandot Co - Upper Sandusky, OH
Wynkoop - Mt Vernon, OH
Wynne Municipal - Wynne, AR
Wyoming Valle Airport - Wilkes-Barre, PA
Yakataga Intermediate Airport - Yakataga, AK
Yakima Air Terminal - Yakima, WA
Yakutat Airport - Yakutat, AK
Yale - Yale, MI
Yampa Valley Airport - Hayden, CO
Yates Center - Yates Center, KS
Yazoo Co - Yazoo City, MS
Yeager Airport - Charleston, WV
Yelland Airport - Ely, NV
Yellowstone Airport - West Yellowstone, MT
Yellowstone Regional Airport - Cody, WY
Yerington Airport - Yerington, NV
Yes Bay Sea Plane Base - Yes Bay, AK
Yoakum Co - Plains, TX
Yoakum Municipal - Yoakum, TX
Yoder - Louisville, OH
Yolo County Davis Woodland Winters Airport - Davis Woodland Winters, CA
York Airport - York, PA
York Municipal - York, NE
Yosemite National Park Airport - Yosemite National Park, CA
Youngstown Elser Metro - Youngstown, OH
Youngstown-Warren Regional Airport - Youngstown, OH
Yreka Airport - Yreka, CA
Yuba - Elk Rapids, MI
Yuba County Airport - Marysville, CA
Yucca Flat Airport - Yucca Flat, NV
Yucca Valley - Yucca Valley, CA
Yuma International Airport - Yuma, AZ
Yuma Municipal - Yuma, CO
Zachar Bay Sea Plane Base - Zachar Bay, AK
Zahns Airport - Amityville, NY
Zamperini Field - Torrance, CA
Zanesville Airport - Zanesville, OH
Zapata Co - Zapata, TX
Zehnder - Frankenmuth, MI
Zelienople Municipal - Zelienople, PA
Zelmer Memorial - Palmyra, IL
Zephyrhills Airport - Zephyrhills, FL
